302,GTI2013,.,500,TAI SIN ELECTRIC LIMITED,30-Jun-12,46,-10,36
379,GTI2012,.,500,TAI SIN ELECTRIC LTD,30-Jun-11,39,-8,31
186,GTI2011,.,500,TAI SIN ELECTRIC LIMITED,30-Jun-10,43,-7,36
417,GTI2010,.,500,TAI SIN ELECTRIC LIMITED,30-Jun-09,35,-5,30
330,GTI2009,.,500,TAI SIN ELECTRIC LIMITED,30-Jun-08,42,-8,34
185,GTI2013,.,502,HSR GLOBAL LIMITED,31-Dec-12,43,-2,41
292,GTI2012,.,502,HSR GLOBAL LTD,31-Dec-10,34,0,34
407,GTI2011,.,502,HSR GLOBAL LTD (FORMERLY WEPCO LIMITED),31-Dec-09,29,-2,27
447,GTI2010,.,502,WEPCO LIMITED,31-Dec-08,26,3,29
629,GTI2009,.,502,WEPCO LIMITED,31-Dec-07,25,-5,20
230,GTI2013,.,504,KLW HOLDINGS LTD,31-Dec-12,39,0,39
500,GTI2012,.,504,KLW HLDGS LTD,31-Dec-10,28,-2,26
430,GTI2011,.,504,KLW HOLDINGS LTD,31-Dec-09,31,-5,26
586,GTI2010,.,504,KLW HOLDINGS LTD,31-Dec-08,26,-3,23
383,GTI2009,.,504,KLW HOLDINGS LTD,31-Dec-07,32,0,32
430,GTI2013,.,505,ASIAMEDIC LIMITED,31-Dec-12,30,1,31
533,GTI2012,.,505,ASIAMEDIC LTD,31-Dec-10,25,0,25
377,GTI2011,.,505,ASIAMEDIC LIMITED,31-Dec-09,31,-3,28
323,GTI2010,.,505,ASIAMEDIC LIMITED,31-Dec-08,33,0,33
111,GTI2009,.,505,ASIAMEDIC LIMITED,31-Dec-07,38,3,41
544,GTI2013,.,508,FUJI OFFSET PLATES MFG LTD,31-Dec-12,33,-7,26
550,GTI2012,.,508,FUJI OFFSET PLATES MANUFACTURING LTD,31-Dec-10,30,-6,24
575,GTI2011,.,508,FUJI OFFSET PLATES MFG LTD,31-Dec-09,28,-11,17
620,GTI2010,.,508,FUJI OFFSET PLATES MFG LTD,31-Dec-08,26,-6,20
662,GTI2009,.,508,FUJI OFFSET PLATES MFG LTD,31-Dec-07,20,-8,12
450,GTI2013,.,510,HIAP SENG ENGINEERING LTD,31-Mar-12,35,-5,30
483,GTI2012,.,510,HIAP SENG ENGINEERING LTD,31-Mar-11,32,-5,27
230,GTI2011,.,510,HIAP SENG ENGINEERING LTD,31-Mar-10,39,-5,34
235,GTI2010,.,510,HIAP SENG ENGINEERING LTD,31-Mar-09,39,-3,36
485,GTI2009,.,510,HIAP SENG ENGINEERING LTD,31-Mar-08,36,-8,28
544,GTI2013,.,519,TOP GLOBAL LIMITED,31-Dec-12,33,-7,26
652,GTI2012,.,519,TOP GLOBAL LTD,31-Dec-10,27,-12,15
629,GTI2011,.,519,TOP GLOBAL LIMITED,31-Dec-09,23,-12,11
524,GTI2010,.,519,TOP GLOBAL LIMITED,31-Dec-08,28,-2,26
574,GTI2009,.,519,TOP GLOBAL LIMITED,31-Dec-07,29,-5,24
252,GTI2013,.,526,HG METAL MANUFACTURING LTD,31-Dec-12,53,-15,38
659,GTI2012,.,526,HG METAL MANUFACTURING LTD,30-Sep-11,38,-25,13
650,GTI2011,.,526,HG METAL MANUFACTURING LTD,30-Sep-10,42,-41,1
608,GTI2010,.,526,HG METAL MANUFACTURING LTD,30-Sep-08,42,-21,21
111,GTI2009,.,526,HG METAL MANUFACTURING LTD,30-Sep-07,44,-3,41
41,GTI2013,.,528,SECOND CHANCE PROPERTIES LTD,31-Aug-12,52,13,65
292,GTI2012,.,528,SECOND CHANCE PROPERTIES LTD,30-Jun-11,33,1,34
325,GTI2011,.,528,SECOND CHANCE PROPERTIES LTD,30-Jun-10,29,1,30
352,GTI2010,.,528,SECOND CHANCE PROPERTIES LTD,30-Jun-09,31,1,32
357,GTI2009,.,528,SECOND CHANCE PROPERTIES LTD,30-Jun-08,32,1,33
643,GTI2013,.,529,FOOD JUNCTION HOLDINGS LIMITED,31-Dec-12,32,-15,17
410,GTI2012,.,529,FOOD JUNCTION HLDGS LTD,31-Dec-10,45,-15,30
618,GTI2011,.,529,FOOD JUNCTION HOLDINGS LIMITED,31-Dec-09,32,-19,13
620,GTI2010,.,529,FOOD JUNCTION HOLDINGS LIMITED,30-Sep-08,33,-13,20
615,GTI2009,.,529,FOOD JUNCTION HOLDINGS LIMITED,30-Sep-07,37,-16,21
122,GTI2013,.,530,CEDAR STRATEGIC HOLDINGS LTD,31-Dec-12,46,1,47
220,GTI2012,.,530,CHINA TITANIUM LTD,30-Sep-11,39,-2,37
149,GTI2011,.,530,CHINA TITANIUM LTD (FORMERLY JADE TECHNOLOGIES HLDGS LTD.),30-Sep-10,43,-5,38
296,GTI2010,.,530,JADE TECHNOLOGIES HLDGS LTD.,30-Sep-08,40,-6,34
252,GTI2013,.,532,EQUATION CORP LIMITED,30-Jun-12,46,-8,38
500,GTI2012,.,532,EQUATION CORP LTD,30-Jun-11,37,-11,26
281,GTI2011,.,532,EQUATION CORP LIMITED,30-Jun-10,40,-8,32
99,GTI2010,.,532,EQUATION CORP LIMITED,30-Jun-09,48,-5,43
196,GTI2009,.,532,EQUATION CORP LIMITED,30-Jun-08,43,-5,38
450,GTI2013,.,533,ABR HOLDINGS LIMITED,31-Dec-12,38,-8,30
550,GTI2012,.,533,ABR HLDGS LTD,31-Dec-10,32,-8,24
479,GTI2011,.,533,ABR HOLDINGS LIMITED,31-Dec-09,32,-8,24
564,GTI2010,.,533,ABR HOLDINGS LIMITED,31-Dec-08,30,-6,24
463,GTI2009,.,533,ABR HOLDINGS LIMITED,30-Jun-08,30,-1,29
598,GTI2013,.,535,VIBROPOWER CORPORATION LIMITED,31-Dec-12,28,-6,22
622,GTI2012,.,535,VIBROPOWER CORP LTD,31-Dec-10,25,-6,19
496,GTI2011,.,535,VIBROPOWER CORPORATION LIMITED,31-Dec-09,26,-3,23
586,GTI2010,.,535,VIBROPOWER CORPORATION LIMITED,31-Dec-08,26,-3,23
505,GTI2009,.,535,VIBROPOWER CORPORATION LIMITED,31-Dec-07,32,-5,27
588,GTI2013,.,536,GOLDTRON LIMITED,30-Jun-12,37,-14,23
587,GTI2012,.,536,GOLDTRON LTD,30-Jun-11,28,-6,22
618,GTI2011,.,536,GOLDTRON LIMITED,30-Jun-10,21,-8,13
564,GTI2010,.,536,GOLDTRON LIMITED,30-Jun-09,27,-3,24
591,GTI2009,.,536,GOLDTRON LIMITED,30-Jun-08,23,0,23
612,GTI2013,.,538,ASJ HOLDINGS LTD,31-Dec-12,24,-3,21
550,GTI2012,.,538,ASJ HLDGS LTD,31-Dec-10,27,-3,24
407,GTI2011,.,538,ASJ HOLDINGS LTD,31-Dec-09,29,-2,27
148,GTI2010,.,538,ASJ HOLDINGS LTD,31-Dec-08,42,-2,40
97,GTI2009,.,538,ASJ HOLDINGS LTD,31-Dec-07,44,-2,42
612,GTI2013,.,539,CPH LTD,31-Mar-12,27,-6,21
550,GTI2012,.,539,CPH LTD,31-Mar-11,24,0,24
604,GTI2011,.,539,CPH LTD,31-Mar-10,24,-9,15
468,GTI2010,.,539,CPH LTD,31-Mar-09,30,-2,28
505,GTI2009,.,539,CPH LTD (FORMERLY CIRCUITS PLUS HOLDINGS LTD),31-Mar-08,29,-2,27
480,GTI2013,.,540,TUNG LOK RESTAURANTS (2000) LTD,31-Mar-12,37,-8,29
587,GTI2012,.,540,TUNG LOK RESTAURANTS (2000) LTD,31-Mar-11,33,-11,22
281,GTI2011,.,540,TUNG LOK RESTAURANTS 2000 LTD,31-Mar-10,34,-2,32
129,GTI2010,.,540,TUNG LOK RESTAURANTS 2000 LTD,31-Mar-09,40,1,41
228,GTI2009,.,540,TUNG LOK RESTAURANTS 2000 LTD,31-Mar-08,42,-5,37
230,GTI2013,.,541,CRAFT PRINT INTERNATIONAL LTD,30-Sep-12,41,-2,39
196,GTI2012,.,541,CRAFT PRINT INTERNATIONAL LTD,30-Sep-11,38,0,38
76,GTI2011,.,541,CRAFT PRINT INTERNATIONAL LTD,30-Sep-10,43,1,44
196,GTI2010,.,541,CRAFT PRINT INTERNATIONAL LTD,30-Sep-08,40,-2,38
111,GTI2009,.,541,CRAFT PRINT INTERNATIONAL LTD,30-Sep-07,46,-5,41
450,GTI2013,.,542,GIKEN SAKATA (S) LIMITED,31-Aug-12,30,0,30
622,GTI2012,.,542,GIKEN SAKATA (S) LTD,31-Aug-11,19,0,19
325,GTI2011,.,542,GIKEN SAKATA (S) LIMITED,31-Aug-10,33,-3,30
352,GTI2010,.,542,GIKEN SAKATA (S) LIMITED,31-Mar-09,32,0,32
505,GTI2009,.,542,GIKEN SAKATA (S) LIMITED,31-Mar-08,27,0,27
598,GTI2013,.,543,NOEL GIFTS INTERNATIONAL LTD,30-Jun-12,27,-5,22
641,GTI2012,.,543,NOEL GIFTS INTERNATIONAL LTD,30-Jun-11,22,-5,17
575,GTI2011,.,543,NOEL GIFTS INTERNATIONAL LTD,30-Jun-10,25,-8,17
543,GTI2010,.,543,NOEL GIFTS INTERNATIONAL LTD,30-Jun-09,28,-3,25
665,GTI2009,.,543,NOEL GIFTS INTERNATIONAL LTD,30-Jun-08,22,-11,11
66,GTI2013,.,544,CSE GLOBAL LTD,31-Dec-12,57,0,57
46,GTI2012,.,544,CSE GLOBAL LTD,31-Dec-10,57,-3,54
34,GTI2011,.,544,CSE GLOBAL LTD,31-Dec-09,64,-9,55
23,GTI2010,.,544,CSE GLOBAL LTD,31-Dec-08,66,-9,57
82,GTI2009,.,544,CSE GLOBAL LTD,31-Dec-07,52,-9,43
185,GTI2013,.,545,VALLIANZ HOLDINGS LIMITED,31-Dec-12,36,5,41
436,GTI2012,.,545,VALLIANZ HLDGS LTD,31-Dec-10,28,1,29
407,GTI2011,.,545,VALLIANZ HOLDINGS LIMITED (FORMERLY ENZER CORPORATION LIMITED),31-Mar-10,41,-14,27
662,GTI2010,.,545,ENZER CORPORATION LIMITED,31-Mar-09,29,-18,11
383,GTI2009,.,545,ENZER CORPORATION LIMITED,31-Mar-08,37,-5,32
396,GTI2013,.,546,MEDTECS INTERNATIONAL CORP LTD,31-Dec-12,37,-5,32
242,GTI2012,.,546,MEDTECS INTERNATIONAL CORP LTD,31-Dec-10,38,-2,36
325,GTI2011,.,546,MEDTECS INTERNATIONAL CORP LTD,31-Dec-09,37,-7,30
352,GTI2010,.,546,MEDTECS INTERNATIONAL CORP LTD,31-Dec-08,40,-8,32
140,GTI2009,.,546,MEDTECS INTERNATIONAL CORP LTD,31-Dec-07,45,-5,40
630,GTI2013,.,547,NOBEL DESIGN HOLDINGS LTD,31-Dec-12,25,-6,19
633,GTI2012,.,547,NOBEL DESIGN HLDGS LTD,31-Dec-10,27,-9,18
618,GTI2011,.,547,NOBEL DESIGN HOLDINGS LTD,31-Dec-09,22,-9,13
564,GTI2010,.,547,NOBEL DESIGN HOLDINGS LTD,31-Dec-08,33,-9,24
644,GTI2009,.,547,NOBEL DESIGN HOLDINGS LTD,31-Dec-07,23,-5,18
578,GTI2013,.,550,ELITE KSB HOLDINGS LIMITED,30-Jun-12,26,-2,24
622,GTI2012,.,550,ELITE KSB HLDGS LTD,30-Jun-11,18,1,19
407,GTI2011,.,550,ELITE KSB HOLDINGS LIMITED,30-Jun-10,26,1,27
196,GTI2010,.,550,ELITE KSB HOLDINGS LIMITED,30-Jun-09,35,3,38
357,GTI2009,.,550,ELITE KSB HOLDINGS LIMITED,30-Jun-08,32,1,33
18,GTI2013,.,552,QIAN HU CORPORATION LIMITED,31-Dec-12,72,10,82
11,GTI2012,.,552,QIAN HU CORP LTD,31-Dec-10,73,9,82
8,GTI2011,.,552,QIAN HU CORPORATION LIMITED,31-Dec-09,70,10,80
14,GTI2010,.,552,QIAN HU CORPORATION LIMITED,31-Dec-08,63,4,67
15,GTI2009,.,552,QIAN HU CORPORATION LIMITED,31-Dec-07,57,-2,55
598,GTI2013,.,554,KING WAN CORPORATION LIMITED,31-Mar-12,38,-16,22
611,GTI2012,.,554,KING WAN CORP LTD,31-Mar-11,36,-16,20
479,GTI2011,.,554,KING WAN CORPORATION LIMITED,31-Mar-10,37,-13,24
129,GTI2010,.,554,KING WAN CORPORATION LIMITED,31-Mar-09,41,0,41
442,GTI2009,.,554,KING WAN CORPORATION LIMITED,31-Mar-08,35,-5,30
132,GTI2013,.,557,VIKING OFFSHORE AND MARINE LTD,31-Dec-12,49,-3,46
436,GTI2012,.,557,VIKING OFFSHORE AND MARINE LTD,31-Dec-10,32,-3,29
514,GTI2011,.,557,VIKING OFFSHORE AND MARINE LTD (FORMERLY NOVENA HOLDINGS LIMITED),31-Dec-09,47,-25,22
608,GTI2010,.,557,VIKING OFFSHORE AND MARINE LTD (FORMERLY NOVENA HOLDINGS LIMITED),31-Dec-08,37,-16,21
292,GTI2009,.,557,NOVENA HOLDINGS LIMITED,31-Dec-07,40,-5,35
132,GTI2013,.,558,UMS HOLDINGS LIMITED,31-Dec-12,52,-6,46
73,GTI2012,.,558,UMS HLDGS LTD,31-Dec-10,55,-6,49
42,GTI2011,.,558,UMS HOLDINGS LIMITED,31-Dec-09,53,-2,51
216,GTI2010,.,558,UMS HOLDINGS LIMITED,31-Dec-08,39,-2,37
111,GTI2009,.,558,UMS HOLDINGS LIMITED,31-Dec-07,46,-5,41
84,GTI2013,.,560,AZTECH GROUP LTD,31-Dec-12,54,-2,52
156,GTI2012,.,560,AZTECH GROUP LTD,31-Dec-10,48,-8,40
66,GTI2011,.,560,AZTECH GROUP LTD.,31-Dec-09,54,-8,46
33,GTI2010,.,560,AZTECH GROUP LTD.,31-Dec-08,55,-3,52
111,GTI2009,.,560,AZTECH SYSTEMS LTD,31-Dec-07,47,-6,41
480,GTI2013,.,561,TECKWAH INDUSTRIAL CORP LTD,31-Dec-12,38,-9,29
565,GTI2012,.,561,TECKWAH INDUSTRIAL CORP LTD,31-Dec-10,32,-9,23
544,GTI2011,.,561,TECKWAH INDUSTRIAL CORP LTD,31-Dec-09,32,-12,20
543,GTI2010,.,561,TECKWAH INDUSTRIAL CORP LTD,31-Dec-08,34,-9,25
615,GTI2009,.,561,TECKWAH INDUSTRIAL CORP LTD,31-Dec-07,33,-12,21
450,GTI2013,.,564,SPINDEX INDUSTRIES LIMITED,30-Jun-12,27,3,30
500,GTI2012,.,564,SPINDEX INDUSTRIES LTD,30-Jun-11,25,1,26
430,GTI2011,.,564,SPINDEX INDUSTRIES LIMITED,30-Jun-10,31,-5,26
498,GTI2010,.,564,SPINDEX INDUSTRIES LIMITED,30-Jun-09,29,-2,27
357,GTI2009,.,564,SPINDEX INDUSTRIES LIMITED,30-Jun-08,36,-3,33
154,GTI2013,.,566,SEE HUP SENG LIMITED,31-Dec-12,44,0,44
268,GTI2012,.,566,SEE HUP SENG LTD,31-Dec-10,41,-6,35
149,GTI2011,.,566,SEE HUP SENG LIMITED,31-Dec-09,43,-5,38
395,GTI2010,.,566,SEE HUP SENG LIMITED,31-Dec-08,41,-10,31
607,GTI2009,.,566,SEE HUP SENG LIMITED,31-Dec-07,38,-16,22
396,GTI2013,.,567,COLEX HOLDINGS LIMITED,31-Dec-12,35,-3,32
268,GTI2012,.,567,COLEX HLDGS LTD,31-Dec-10,35,0,35
254,GTI2011,.,567,COLEX HOLDINGS LIMITED,31-Dec-09,37,-4,33
417,GTI2010,.,567,COLEX HOLDINGS LIMITED,31-Dec-08,32,-2,30
357,GTI2009,.,567,COLEX HOLDINGS LIMITED,31-Dec-07,35,-2,33
52,GTI2013,.,568,BAKER TECHNOLOGY LIMITED,31-Dec-12,66,-5,61
30,GTI2012,.,568,BAKER TECHNOLOGY LTD,31-Dec-10,66,0,66
38,GTI2011,.,568,BAKER TECHNOLOGY LIMITED,31-Dec-09,60,-6,54
64,GTI2010,.,568,BAKER TECHNOLOGY LIMITED,31-Dec-08,49,-3,46
292,GTI2009,.,568,BAKER TECHNOLOGY LIMITED,31-Dec-07,41,-6,35
480,GTI2013,.,569,VICPLAS INTERNATIONAL LTD,31-Jul-12,40,-11,29
242,GTI2012,.,569,VICPLAS INTERNATIONAL LTD,31-Jul-11,41,-5,36
281,GTI2011,.,569,VICPLAS INTERNATIONAL LTD,31-Jul-10,37,-5,32
267,GTI2010,ANN2879J1070,569,VICPLAS INTERNATIONAL LTD,31-Jul-09,37,-2,35
591,GTI2009,ANN2879J1070,569,VICPLAS INTERNATIONAL LTD,31-Jul-08,29,-6,23
430,GTI2013,ANN2879J1070,570,TRANSIT-MIXED CONCRETE LTD,29-Feb-12,34,-3,31
533,GTI2012,ANN2879J1070,570,TRANSIT-MIXED CONCRETE LTD,28-Feb-11,28,-3,25
407,GTI2011,BMG007FR1026,570,TRANSIT-MIXED CONCRETE LTD,28-Feb-10,30,-3,27
395,GTI2010,BMG007FR1026,570,TRANSIT-MIXED CONCRETE LTD,28-Feb-09,34,-3,31
615,GTI2009,BMG007FR1026,570,TRANSIT-MIXED CONCRETE LTD,29-Feb-08,29,-8,21
503,GTI2013,BMG007FR1026,571,INTERNATIONAL PRESS SOFTCOM,31-Dec-12,36,-8,28
565,GTI2012,BMG007FR1026,571,INTERNATIONAL PRESS SOFTCOM LTD,31-Dec-10,29,-6,23
544,GTI2011,BMG045121024,571,INTERNATIONAL PRESS SOFTCOM,31-Dec-09,33,-13,20
608,GTI2010,BMG045121024,571,INTERNATIONAL PRESS SOFTCOM,31-Dec-08,38,-17,21
166,GTI2009,BMG045121024,571,INTERNATIONAL PRESS SOFTCOM,31-Dec-07,44,-5,39
480,GTI2013,BMG045121024,573,CHALLENGER TECHNOLOGIES LTD,31-Dec-12,31,-2,29
550,GTI2012,BMG045121024,573,CHALLENGER TECHNOLOGIES LTD,31-Dec-10,26,-2,24
479,GTI2011,BMG053861180,573,CHALLENGER TECHNOLOGIES LTD,31-Dec-09,28,-4,24
468,GTI2010,BMG053861180,573,CHALLENGER TECHNOLOGIES LTD,31-Dec-08,30,-2,28
407,GTI2009,BMG053861180,573,CHALLENGER TECHNOLOGIES LTD,31-Dec-07,33,-2,31
430,GTI2013,BMG053861180,574,TSH CORPORATION LIMITED,31-Dec-12,36,-5,31
268,GTI2012,BMG053861180,574,TSH CORP LTD,31-Dec-10,38,-3,35
254,GTI2011,BMG0539Q1050,574,TSH CORPORATION LIMITED,31-Dec-09,38,-5,33
129,GTI2010,BMG0539Q1050,574,TSH CORPORATION LIMITED,31-Dec-08,43,-2,41
70,GTI2009,BMG0539Q1050,574,TSH CORPORATION LIMITED,31-Dec-07,49,-5,44
185,GTI2013,BMG0539Q1050,575,ASTI HOLDINGS LIMITED,31-Dec-12,43,-2,41
196,GTI2012,BMG075391026,575,ASTI HLDGS LTD,31-Dec-10,41,-3,38
140,GTI2011,BMG075391026,575,ASTI HOLDINGS LIMITED,31-Dec-09,42,-3,39
82,GTI2010,BMG075391026,575,ASTI HOLDINGS LIMITED,31-Dec-08,44,0,44
53,GTI2009,BMG075391026,575,ASTI HOLDINGS LIMITED,31-Dec-07,46,0,46
154,GTI2013,BMG075391026,576,MAGNUS ENERGY GROUP LTD.,30-Jun-12,43,1,44
220,GTI2012,BMG113251000,576,MAGNUS ENERGY GROUP LTD,30-Jun-11,43,-6,37
346,GTI2011,BMG113251000,576,MAGNUS ENERGY GROUP LTD.,30-Jun-10,42,-13,29
148,GTI2010,BMG113251000,576,MAGNUS ENERGY GROUP LTD.,30-Jun-09,45,-5,40
330,GTI2009,BMG113251000,576,MAGNUS ENERGY GROUP LTD.,30-Jun-08,39,-5,34
273,GTI2013,BMG113251000,578,KS ENERGY LIMITED,31-Dec-12,39,-2,37
268,GTI2012,BMG1367H1007,578,KS ENERGY LTD,31-Dec-10,34,1,35
186,GTI2011,BMG1367H1007,578,KS ENERGY SERVICES LIMITED,31-Dec-09,41,-5,36
99,GTI2010,BMG1367H1007,578,KS ENERGY SERVICES LIMITED,31-Dec-08,46,-3,43
82,GTI2009,BMG1367H1007,578,KS ENERGY SERVICES LIMITED,31-Dec-07,46,-3,43
661,GTI2013,BMG1367H1007,579,OCEANUS GROUP LIMITED,31-Dec-11,34,-28,6
646,GTI2012,BMG1792W1284,579,OCEANUS GROUP LTD,31-Dec-10,28,-12,16
165,GTI2011,BMG1792W1284,579,OCEANUS GROUP LIMITED,31-Dec-09,41,-4,37
216,GTI2010,BMG1820V1000,579,OCEANUS GROUP LIMITED,31-Dec-08,39,-2,37
480,GTI2013,BMG1820V1000,580,SANTAK HOLDINGS LIMITED,30-Jun-12,34,-5,29
656,GTI2012,BMG1820V1000,580,SANTAK HLDGS LTD,30-Jun-11,25,-11,14
514,GTI2011,BMG1820V1000,580,SANTAK HOLDINGS LIMITED,30-Jun-10,27,-5,22
586,GTI2010,BMG1820V1000,580,SANTAK HOLDINGS LIMITED,30-Jun-09,31,-8,23
591,GTI2009,BMG1989W1055,580,SANTAK HOLDINGS LIMITED,30-Jun-08,31,-8,23
230,GTI2013,BMG1989W1055,581,ITE ELECTRIC CO LTD,31-Dec-12,36,3,39
196,GTI2012,BMG2022E1021,581,ITE ELECTRIC COMPANY LTD,31-Dec-10,37,1,38
165,GTI2011,BMG2022E1021,581,ITE ELECTRIC CO LTD,31-Dec-09,34,3,37
352,GTI2010,BMG2022E1021,581,ITE ELECTRIC CO LTD,31-Dec-08,32,0,32
111,GTI2009,BMG2022E1021,581,ITE ELECTRIC CO LTD,31-Dec-07,43,-2,41
480,GTI2013,BMG2022E1021,583,PROGEN HOLDINGS LTD,31-Dec-12,37,-8,29
674,GTI2012,BMG2108U1036,583,PROGEN HLDGS LTD,31-Dec-10,21,-24,-3
648,GTI2011,BMG2108U1036,583,PROGEN HOLDINGS LTD,31-Dec-09,22,-19,3
640,GTI2010,BMG2108U1036,583,PROGEN HOLDINGS LTD,31-Dec-08,19,-3,16
674,GTI2009,BMG2108U1036,583,PROGEN HOLDINGS LTD,31-Dec-07,17,-11,6
91,GTI2013,BMG2108U1036,584,OAKWELL ENGINEERING LIMITED,31-Dec-12,51,0,51
565,GTI2012,BMG210A21029,584,OAKWELL ENGINEERING LTD,31-Dec-10,32,-9,23
496,GTI2011,BMG210A21029,584,OAKWELL ENGINEERING LIMITED,31-Dec-09,29,-6,23
599,GTI2010,BMG210A21029,584,OAKWELL ENGINEERING LIMITED,31-Dec-08,27,-5,22
529,GTI2009,BMG210A21029,584,OAKWELL ENGINEERING LIMITED,31-Dec-07,34,-8,26
612,GTI2013,BMG210A21029,585,ASIAN MICRO HOLDINGS LTD,30-Jun-12,38,-17,21
652,GTI2012,BMG2110F1023,585,ASIAN MICRO HLDGS LTD,30-Jun-11,30,-15,15
458,GTI2011,BMG2110F1023,585,ASIAN MICRO HOLDINGS LTD,30-Jun-10,36,-11,25
615,GTI2009,BMG2110F1023,585,ASIAN MICRO HOLDINGS LTD,30-Jun-08,39,-18,21
132,GTI2013,BMG2110F1023,586,TMC EDUCATION CORPORATION LTD,30-Jun-12,51,-5,46
105,GTI2012,BMG2110F1023,586,TMC EDUCATION CORP LTD,30-Jun-11,47,-3,44
281,GTI2011,BMG211151037,586,TMC EDUCATION CORPORATION LTD,30-Jun-10,48,-16,32
296,GTI2010,BMG211151037,586,TMC EDUCATION CORPORATION LTD,31-Dec-08,44,-10,34
591,GTI2009,BMG211151037,586,TMC EDUCATION CORPORATION LTD,31-Dec-07,38,-15,23
230,GTI2013,BMG211151037,587,LERENO BIO-CHEM LTD,31-Mar-12,36,3,39
43,GTI2012,BMG2111L1081,587,LERENO BIO-CHEM LTD,31-Mar-11,46,9,55
46,GTI2011,BMG2111L1081,587,LERENO BIO-CHEM LTD.,31-Mar-10,47,3,50
40,GTI2010,BMG2111L1081,587,LERENO BIO-CHEM LTD.,31-Mar-09,48,3,51
97,GTI2009,BMG2111L1081,587,LERENO BIO-CHEM LTD.,31-Mar-08,42,0,42
480,GTI2013,BMG2111L1081,588,HEALTH MANAGEMENT INTL LTD,30-Jun-12,39,-10,29
483,GTI2012,BMG2113G1078,588,HEALTH MANAGEMENT INTERNATIONAL LTD,30-Jun-11,38,-11,27
514,GTI2011,BMG2113G1078,588,HEALTH MANAGEMENT INTL LTD,30-Jun-10,32,-10,22
417,GTI2010,BMG2113G1078,588,HEALTH MANAGEMENT INTL LTD,30-Jun-09,35,-5,30
228,GTI2009,BMG2113G1078,588,HEALTH MANAGEMENT INTL LTD,30-Jun-08,42,-5,37
185,GTI2013,BMG2113G1078,591,INNOVALUES LIMITED,31-Dec-12,46,-5,41
131,GTI2012,BMG215451011,591,INNOVALUES LTD,31-Dec-10,45,-3,42
129,GTI2011,BMG215451011,591,INNOVALUES LIMITED,31-Dec-09,51,-11,40
267,GTI2010,BMG215451011,591,INNOVALUES LIMITED,31-Dec-08,49,-14,35
70,GTI2009,BMG215451011,591,INNOVALUES LIMITED,31-Dec-07,55,-11,44
326,GTI2013,BMG2154D1121,593,LEE METAL GROUP LTD,31-Dec-12,34,1,35
268,GTI2012,BMG2154D1121,593,LEE METAL GROUP LTD,31-Dec-10,37,-2,35
230,GTI2011,BMG2154D1121,593,LEE METAL GROUP LTD,31-Dec-09,33,1,34
323,GTI2010,BMG2154X1002,593,LEE METAL GROUP LTD,31-Dec-08,35,-2,33
228,GTI2009,BMG2154X1002,593,LEE METAL GROUP LTD,31-Dec-07,39,-2,37
326,GTI2013,BMG2154X1002,594,LOYZ ENERGY LIMITED,30-Jun-12,35,0,35
500,GTI2012,BMG2154X1002,594,LOYZ ENERGY LTD,30-Jun-11,26,0,26
377,GTI2011,BMG2154X1002,594,SIM SIANG CHOON LIMITED,30-Jun-10,29,-1,28
599,GTI2010,BMG2156K1062,594,SIM SIANG CHOON LIMITED,30-Jun-09,24,-2,22
607,GTI2009,BMG2156K1062,594,SIM SIANG CHOON LIMITED,30-Jun-08,29,-7,22
544,GTI2013,BMG2156K1062,595,GKE CORPORATION LIMITED,31-May-12,30,-4,26
196,GTI2012,BMG2156K1484,595,VAN DER HORST ENERGY LTD,31-May-11,35,3,38
496,GTI2011,BMG2156K1484,595,VAN DER HORST ENERGY LIMITED,31-May-10,27,-4,23
524,GTI2010,BMG2157D1011,595,VAN DER HORST ENERGY LIMITED,31-May-09,31,-5,26
650,GTI2009,BMG2157D1011,595,VAN DER HORST ENERGY LIMITED,31-May-08,32,-15,17
353,GTI2013,BMG2157D1011,596,THAI VILLAGE HOLDINGS LTD,30-Sep-12,39,-5,34
379,GTI2012,BMG2157D1011,596,THAI VILLAGE HLDGS LTD,30-Sep-11,37,-6,31
325,GTI2011,BMG2157D1011,596,THAI VILLAGE HOLDINGS LTD,30-Sep-10,38,-8,30
564,GTI2010,BMG2157D1011,596,THAI VILLAGE HOLDINGS LTD,30-Sep-08,32,-8,24
574,GTI2009,BMG2158U1100,596,THAI VILLAGE HOLDINGS LTD,30-Sep-07,35,-11,24
77,GTI2013,BMG2158U1100,600,HYFLUX LTD,31-Dec-12,52,1,53
82,GTI2012,BMG2158U1100,600,HYFLUX LTD,31-Dec-10,49,-2,47
165,GTI2011,BMG2158U1100,600,HYFLUX LTD,31-Dec-09,49,-12,37
296,GTI2010,BMG215901155,600,HYFLUX LTD,31-Dec-08,39,-5,34
591,GTI2009,BMG215901155,600,HYFLUX LTD,31-Dec-07,36,-13,23
91,GTI2013,BMG215901155,5AB ,TREK 2000 INT'L LTD,31-Dec-12,54,-3,51
242,GTI2012,BMG215901155,5AB ,TREK 2000 INTERNATIONAL LTD,31-Dec-10,39,-3,36
129,GTI2011,BMG215901155,5AB ,TREK 2000 INT'L LTD,31-Dec-09,46,-6,40
82,GTI2010,BMG2159Z1005,5AB ,TREK 2000 INT'L LTD,31-Dec-08,44,0,44
82,GTI2009,BMG2159Z1005,5AB ,TREK 2000 INT'L LTD,31-Dec-07,46,-3,43
612,GTI2013,BMG2159Z1005,5AC ,NH CERAMICS LTD,30-Sep-12,23,-2,21
588,GTI2011,BMG2159Z1005,5AC ,NH CERAMICS LTD,30-Sep-10,18,-2,16
608,GTI2010,BMG2159Z1005,5AC ,NH CERAMICS LTD,30-Sep-08,21,0,21
574,GTI2009,BMG2518W1038,5AC ,NH CERAMICS LTD,30-Sep-07,24,0,24
656,GTI2013,BMG2518W1038,5AE ,POLLUX PROPERTIES LTD.,31-Mar-12,23,-14,9
664,GTI2012,BMG2518W1038,5AE ,POLLUX PROPERTIES LTD,31-Mar-11,18,-8,10
604,GTI2011,BMG2518W1038,5AE ,POLLUX PROPERTIES LTD (FORMERLY SHINING CORPORATION LTD),31-Mar-10,20,-5,15
543,GTI2010,BMG2520U1374,5AE ,SHINING CORPORATION LTD,31-Dec-08,28,-3,25
529,GTI2009,BMG2520U1374,5AE ,SHINING CORPORATION LTD,31-Dec-07,28,-2,26
430,GTI2013,BMG2520U1374,5AI ,SUNLIGHT GROUP HLDG LTD,31-Mar-12,35,-4,31
292,GTI2012,BMG2520U1374,5AI ,SUNLIGHT GROUP HLDG LTD,31-Mar-11,33,1,34
346,GTI2011,BMG2520U1374,5AI ,SUNLIGHT GROUP HLDG LTD,31-Mar-10,33,-4,29
352,GTI2010,BMG2535T1099,5AI ,SUNLIGHT GROUP HLDG LTD,31-Mar-09,34,-2,32
505,GTI2009,BMG2535T1099,5AI ,SUNLIGHT GROUP HLDG LTD,31-Mar-08,29,-2,27
252,GTI2013,BMG2535T1099,5AL ,ANNICA HOLDINGS LIMITED,31-Dec-12,42,-4,38
131,GTI2012,BMG2535T1099,5AL ,ANNICA HLDGS LTD,31-Dec-10,39,3,42
165,GTI2011,BMG2535T1099,5AL ,ANNICA HOLDINGS LTD (FORMERLY OCULUS LIMITED),31-Dec-09,36,1,37
633,GTI2010,BMG2656V1072,5AL ,ANNICA HOLDINGS LTD (FORMERLY OCULUS LIMITED),31-Dec-08,35,-17,18
634,GTI2009,BMG2656V1072,5AL ,OCULUS LIMITED,31-Dec-07,34,-15,19
396,GTI2013,BMG2656V1072,5AM ,ASIATRAVEL.COM HOLDINGS LTD,30-Sep-12,36,-4,32
602,GTI2012,BMG2656V1072,5AM ,ASIATRAVEL.COM HLDGS LTD,30-Sep-11,23,-2,21
346,GTI2011,BMG278221087,5AM ,ASIATRAVEL.COM HOLDINGS LTD,30-Sep-10,39,-10,29
498,GTI2010,BMG278221087,5AM ,ASIATRAVEL.COM HOLDINGS LTD,30-Sep-08,35,-8,27
463,GTI2009,BMG278221087,5AM ,ASIATRAVEL.COM HOLDINGS LTD,30-Sep-07,36,-7,29
566,GTI2013,BMG278221087,5AU ,AP OIL INTERNATIONAL LIMITED,31-Dec-12,37,-12,25
672,GTI2012,BMG278221087,5AU ,AP OIL INTERNATIONAL LTD,31-Dec-10,30,-25,5
648,GTI2011,BMG2860H1007,5AU ,AP OIL INTERNATIONAL LIMITED,31-Dec-09,28,-25,3
395,GTI2010,BMG2860H1007,5AU ,AP OIL INTERNATIONAL LIMITED,31-Dec-08,31,0,31
485,GTI2009,BMG2860H1007,5AU ,AP OIL INTERNATIONAL LIMITED,31-Dec-07,28,0,28
655,GTI2013,BMG2860H1007,5BA ,VASHION GROUP LTD.,31-Dec-11,23,-11,12
500,GTI2012,BMG3087Y1084,5BA ,VASHION GROUP LTD,31-Dec-10,25,1,26
514,GTI2011,BMG3087Y1084,5BA ,VASHION GROUP LTD.,31-Dec-09,27,-5,22
296,GTI2010,BMG3087Y1084,5BA ,VASHION GROUP LTD.,31-Dec-08,33,1,34
228,GTI2009,BMG3087Y1084,5BA ,VASHION GROUP LTD.,31-Dec-07,36,1,37
396,GTI2013,BMG3087Y1084,5BI ,CARRIERNET GLOBAL LTD,31-Dec-12,38,-6,32
550,GTI2012,BMG334731103,5BI ,CARRIERNET GLOBAL LTD,31-Dec-10,27,-3,24
346,GTI2011,BMG334731103,5BI ,CARRIERNET GLOBAL LTD,31-Dec-09,41,-12,29
72,GTI2010,BMG334731103,5BI ,CARRIERNET GLOBAL LTD,31-Dec-08,50,-5,45
196,GTI2009,BMG334731103,5BI ,CARRIERNET GLOBAL LTD (FORMERLY ARIANECORP),31-Dec-07,48,-10,38
84,GTI2013,BMG334731103,5BK ,KODA LTD,30-Jun-12,48,4,52
29,GTI2012,BMG3397M1091,5BK ,KODA LTD,30-Jun-11,61,6,67
31,GTI2011,BMG3397M1091,5BK ,KODA LTD,30-Jun-10,58,-2,56
48,GTI2010,BMG3397M1091,5BK ,KODA LTD,30-Jun-09,56,-8,48
330,GTI2009,BMG3658Z1041,5BK ,KODA LTD,30-Jun-08,42,-8,34
373,GTI2013,BMG3658Z1041,5BM ,MFS TECHNOLOGY LTD,30-Sep-12,38,-5,33
611,GTI2012,BMG3658Z1041,5BM ,MFS TECHNOLOGY LTD,30-Sep-11,28,-8,20
346,GTI2011,BMG3658Z1041,5BM ,MFS TECHNOLOGY LTD,30-Sep-10,35,-6,29
228,GTI2009,BMG3658Z1041,5BM ,MFS TECHNOLOGY LTD,30-Sep-07,43,-6,37
480,GTI2013,BMG3687W1064,5BS ,PNE MICRON HOLDINGS LTD,30-Sep-12,29,0,29
455,GTI2012,BMG3687W1064,5BS ,PNE MICRON HLDGS LTD,30-Sep-11,33,-5,28
301,GTI2011,BMG3687W1064,5BS ,PNE MICRON HOLDINGS LTD,30-Sep-10,31,0,31
447,GTI2010,BMG3687W1064,5BS ,PNE MICRON HOLDINGS LTD,30-Sep-08,29,0,29
407,GTI2009,BMG3687W1064,5BS ,PNE MICRON HOLDINGS LTD,30-Sep-07,36,-5,31
430,GTI2013,BMG3705H1079,5BT,MOYA ASIA LIMITED,31-Dec-11,36,-5,31
668,GTI2012,BMG3705H1079,5BT,MOYA ASIA LTD,31-Dec-10,29,-21,8
658,GTI2011,BMG3705H1079,5BT,MOYA DAYEN LIMITED (Formerly Dayen Environmental Ltd),30-Sep-09,28,-34,-6
673,GTI2010,BMG3705H1079,5BT,DAYEN ENVIRONMENTAL LIMITED,30-Sep-08,31,-26,5
643,GTI2013,BMG3705H1079,5CB ,DARCO WATER TECHNOLOGIES LTD,31-Dec-12,29,-12,17
646,GTI2012,BMG3722U1071,5CB ,DARCO WATER TECHNOLOGIES LTD,31-Dec-10,20,-4,16
604,GTI2011,BMG3722U1071,5CB ,DARCO WATER TECHNOLOGIES LTD,31-Dec-09,24,-9,15
174,GTI2010,BMG3722U1071,5CB ,DARCO WATER TECHNOLOGIES LTD,31-Dec-08,41,-2,39
357,GTI2009,BMG3722U1071,5CB ,DARCO WATER TECHNOLOGIES LTD,31-Dec-07,35,-2,33
588,GTI2013,BMG3722U1071,5CE ,SINGXPRESS LAND LTD.,31-Mar-12,31,-8,23
533,GTI2012,BMG3931N1002,5CE ,SINGXPRESS LAND LTD,31-Mar-11,25,0,25
514,GTI2011,BMG3931N1002,5CE ,SINGXPRESS LTD.,31-Dec-09,29,-7,22
543,GTI2010,BMG3931N1002,5CE ,SINGXPRESS LTD.,31-Dec-08,30,-5,25
407,GTI2009,BMG3931N1002,5CE ,SINGXPRESS LTD.,31-Dec-07,36,-5,31
115,GTI2013,BMG4210D1020,5CF ,OKP HOLDINGS LIMITED,31-Dec-12,50,-2,48
51,GTI2012,BMG4210D1020,5CF ,OKP HLDGS LTD,31-Dec-10,50,3,53
42,GTI2011,BMG4210D1020,5CF ,OKP HOLDINGS LIMITED,31-Dec-09,53,-2,51
115,GTI2010,BMG4210D1020,5CF ,OKP HOLDINGS LIMITED,31-Dec-08,44,-2,42
140,GTI2009,BMG4210D1020,5CF ,OKP HOLDINGS LIMITED,31-Dec-07,45,-5,40
396,GTI2013,BMG4288B1037,5CH ,DMX TECHNOLOGIES GROUP LTD,31-Dec-12,38,-6,32
565,GTI2012,BMG4288B1037,5CH ,DMX TECHNOLOGIES GROUP LTD,31-Dec-10,28,-5,23
230,GTI2011,BMG4288B1037,5CH ,DMX TECHNOLOGIES GROUP LTD,31-Dec-09,39,-5,34
447,GTI2010,BMG4288B1037,5CH ,DMX TECHNOLOGIES GROUP LTD,31-Dec-08,37,-8,29
357,GTI2009,BMG4288B1037,5CH ,DMX TECHNOLOGIES GROUP LTD,31-Dec-07,35,-2,33
326,GTI2013,BMG458401087,5CJ ,CHINESE GLOBAL INVESTORS GRP,30-Jun-12,43,-8,35
410,GTI2012,BMG459411044,5CJ ,CHINESE GLOBAL INVESTORS GROUP,30-Jun-11,42,-12,30
531,GTI2011,BMG459411044,5CJ ,CHINESE GLOBAL INVESTORS GRP (FORMERLY AUSWIN HOLDINGS LIMITED),30-Jun-10,37,-16,21
352,GTI2010,BMG459411044,5CJ ,AUSWIN HOLDINGS LIMITED (FORMERLY MIDDLE EAST DEVT SPORE LTD),30-Jun-09,46,-14,32
252,GTI2013,BMG4612P1095,5CN ,SINWA LIMITED,31-Dec-12,47,-9,38
500,GTI2012,BMG4612P1095,5CN ,SINWA LTD,31-Dec-10,38,-12,26
544,GTI2011,BMG4612P1095,5CN ,SINWA LIMITED,31-Dec-09,33,-13,20
267,GTI2010,BMG4612P1095,5CN ,SINWA LIMITED,31-Dec-08,38,-3,35
166,GTI2009,BMG4612P1095,5CN ,SINWA LIMITED,31-Dec-07,42,-3,39
525,GTI2013,BMG5103B1037,5CP ,SILVERLAKE AXIS LTD,30-Jun-12,34,-7,27
317,GTI2012,BMG5103B1037,5CP ,SILVERLAKE AXIS LTD,30-Jun-11,35,-2,33
479,GTI2011,BMG5103B1037,5CP ,SILVERLAKE AXIS LTD,30-Jun-10,34,-10,24
174,GTI2010,BMG518851461,5CP ,SILVERLAKE AXIS LTD,30-Jun-09,44,-5,39
407,GTI2009,BMG518851461,5CP ,SILVERLAKE AXIS LTD,30-Jun-08,37,-6,31
450,GTI2013,BMG518851461,5CQ ,TECHNICS OIL & GAS LIMITED,30-Sep-12,32,-2,30
622,GTI2012,BMG518851461,5CQ ,TECHNICS OIL & GAS LTD,30-Sep-11,24,-5,19
377,GTI2011,BMG518851461,5CQ ,TECHNICS OIL & GAS LIMITED,30-Sep-10,36,-8,28
543,GTI2010,BMG521971033,5CQ ,TECHNICS OIL & GAS LIMITED,30-Sep-08,31,-6,25
529,GTI2009,BMG521971033,5CQ ,TECHNICS OIL & GAS LIMITED,30-Sep-07,28,-2,26
525,GTI2013,BMG521971033,5CR ,ASIATIC GROUP (HOLDINGS) LTD,31-Mar-12,29,-2,27
533,GTI2012,BMG521971033,5CR ,ASIATIC GROUP (HLDGS) LTD,31-Mar-11,25,0,25
346,GTI2011,BMG521971033,5CR ,ASIATIC GROUP (HOLDINGS) LTD,31-Mar-10,31,-2,29
352,GTI2010,BMG525671076,5CR ,ASIATIC GROUP (HOLDINGS) LTD,31-Mar-09,34,-2,32
82,GTI2009,BMG525671076,5CR ,ASIATIC GROUP (HOLDINGS) LTD,31-Mar-08,45,-2,43
658,GTI2013,BMG525671076,5CS ,INFINIO GROUP LIMITED,31-Mar-12,31,-23,8
646,GTI2012,BMG525671076,5CS ,INFINIO GROUP LTD,31-Mar-11,34,-18,16
642,GTI2011,BMG525671076,5CS ,INFINIO GROUP LIMITED,31-Mar-10,29,-23,6
564,GTI2010,BMG5352E1057,5CS ,INFINIO GROUP LIMITED,31-Mar-09,40,-16,24
196,GTI2009,BMG5352E1057,5CS ,AUSTON INTERNATIONAL GROUP LTD,31-Mar-08,43,-5,38
174,GTI2013,BMG5352E1057,5CT ,ECOWISE HOLDINGS LIMITED,31-Oct-12,44,-2,42
455,GTI2012,BMG5352E1057,5CT ,ECOWISE HLDGS LTD,31-Oct-10,33,-5,28
407,GTI2011,BMG5352E1057,5CT ,ECOWISE HOLDINGS LIMITED,31-Oct-09,38,-11,27
417,GTI2010,BMG5378M1156,5CT ,ECOWISE HOLDINGS LIMITED,31-Oct-08,38,-8,30
330,GTI2009,BMG5378M1156,5CT ,ECOWISE HOLDINGS LIMITED,31-Oct-07,42,-8,34
122,GTI2013,BMG5378M1156,5DA ,BREADTALK GROUP LIMITED,31-Dec-12,43,4,47
131,GTI2012,BMG5378M1156,5DA ,BREADTALK GROUP LTD,31-Dec-10,49,-7,42
377,GTI2011,BMG5378M1156,5DA ,BREADTALK GROUP LIMITED,31-Dec-09,32,-4,28
296,GTI2010,BMG5487Z1068,5DA ,BREADTALK GROUP LIMITED,31-Dec-08,33,1,34
357,GTI2009,BMG5487Z1068,5DA ,BREADTALK GROUP LIMITED,31-Dec-07,35,-2,33
18,GTI2013,BMG5487Z1068,5DD ,MICRO-MECHANICS (HOLDINGS) LTD,30-Jun-12,72,10,82
22,GTI2012,BMG5487Z1068,5DD ,MICRO-MECHANICS (HLDGS) LTD,30-Jun-11,59,12,71
20,GTI2011,BMG5521X1092,5DD ,MICRO-MECHANICS (HOLDINGS) LTD,30-Jun-10,64,4,68
21,GTI2010,BMG5521X1092,5DD ,MICRO-MECHANICS (HOLDINGS) LTD,30-Jun-09,55,3,58
15,GTI2009,BMG5521X1092,5DD ,MICRO-MECHANICS (HOLDINGS) LTD,30-Jun-08,55,0,55
302,GTI2013,BMG5521X1092,5DE ,EMS ENERGY LIMITED,31-Dec-12,46,-10,36
379,GTI2012,BMG5521X1092,5DE ,EMS ENERGY LTD,31-Dec-10,39,-8,31
230,GTI2011,BMG5635H1079,5DE ,EMS ENERGY LIMITED,31-Dec-09,39,-5,34
72,GTI2010,BMG5635H1079,5DE ,EMS ENERGY LIMITED,31-Dec-08,45,0,45
292,GTI2009,BMG5635H1079,5DE ,EMS ENERGY LIMITED,31-Dec-07,37,-2,35
29,GTI2013,BMG5635H1079,5DM ,YING LI INTL REAL ESTATE LTD,31-Dec-12,64,10,74
25,GTI2012,BMG5635H1079,5DM ,YING LI INTERNATIONAL REAL ESTATE LTD,31-Dec-10,60,9,69
34,GTI2011,BMG5655Q1024,5DM ,YING LI INTL REAL ESTATE LTD,31-Dec-09,56,-1,55
352,GTI2010,BMG5655Q1024,5DM ,YING LI INTL REAL ESTATE LTD,31-Dec-08,34,-2,32
505,GTI2009,BMG5655Q1024,5DM ,YING LI INTL REAL ESTATE LTD (FORMERLY SHOWY INTL LTD),31-Dec-07,30,-3,27
145,GTI2013,BMG5655Q1024,5DN ,EZRA HOLDINGS LIMITED,31-Aug-12,41,4,45
292,GTI2012,BMG5655Q1024,5DN ,EZRA HLDGS LTD,31-Aug-11,37,-3,34
165,GTI2011,BMG5722Z1014,5DN ,EZRA HOLDINGS LIMITED,31-Aug-10,39,-2,37
72,GTI2010,BMG5722Z1014,5DN ,EZRA HOLDINGS LIMITED,31-Aug-09,47,-2,45
61,GTI2009,BMG5722Z1014,5DN ,EZRA HOLDINGS LIMITED,31-Aug-08,47,-2,45
598,GTI2013,BMG5722Z1014,5DO ,SAKAE HOLDINGS LTD,31-Dec-12,37,-15,22
436,GTI2012,BMG5723Q1006,5DO ,SAKAE HLDGS LTD,31-Dec-10,34,-5,29
210,GTI2011,BMG5723Q1006,5DO ,SAKAE HOLDINGS LTD. (FORMERLY APEX-PAL INTERNATIONAL LTD),31-Dec-09,35,0,35
99,GTI2010,BMG5723Q1006,5DO ,APEX-PAL INTERNATIONAL LTD,31-Dec-08,43,0,43
228,GTI2009,BMG5723Q1006,5DO ,APEX-PAL INTERNATIONAL LTD,31-Dec-07,37,0,37
578,GTI2013,BMG5723Q1006,5DP ,HEETON HOLDINGS LIMITED,31-Dec-12,30,-6,24
483,GTI2012,BMG5958R1043,5DP ,HEETON HLDGS LTD,31-Dec-10,29,-2,27
325,GTI2011,BMG5958R1043,5DP ,HEETON HOLDINGS LIMITED,31-Dec-09,30,0,30
498,GTI2010,BMG5958R1043,5DP ,HEETON HOLDINGS LIMITED,31-Dec-08,30,-3,27
228,GTI2009,BMG5958R1043,5DP ,HEETON HOLDINGS LIMITED,31-Dec-07,40,-3,37
49,GTI2013,BMG5958R1043,5DS ,MEGACHEM LIMITED,31-Dec-12,54,9,63
115,GTI2012,BMG6361R1117,5DS ,MEGACHEM LTD,31-Dec-10,40,3,43
62,GTI2011,BMG6361R1117,5DS ,MEGACHEM LIMITED,31-Dec-09,49,-2,47
235,GTI2010,BMG6361R1117,5DS ,MEGACHEM LIMITED,31-Dec-08,36,0,36
196,GTI2009,BMG6361R1117,5DS ,MEGACHEM LIMITED,31-Dec-07,41,-3,38
396,GTI2013,BMG6361R1117,5DT,BRIGHT ORIENT (HOLDING) LTD.,31-Dec-11,36,-4,32
483,GTI2012,BMG6542T1190,5DT,BRIGHT ORIENT (HLDG) LTD,31-Dec-10,29,-2,27
557,GTI2011,BMG6542T1190,5DT,BRIGHT ORIENT (HOLDING) LTD.,31-Dec-09,24,-5,19
352,GTI2010,BMG6542T1190,5DT,BRIGHT ORIENT (HOLDING) LTD.,31-Dec-08,32,0,32
266,GTI2009,BMG6542T1190,5DT,BRIGHT ORIENT (HOLDING) LTD.,31-Dec-07,36,0,36
480,GTI2013,BMG6542T1190,5DW ,RENEWABLE ENERGY ASIA GRP LTD,31-Mar-12,37,-8,29
565,GTI2012,BMG6843Q1033,5DW ,RENEWABLE ENERGY ASIA GRP LTD,31-Mar-11,31,-8,23
635,GTI2011,BMG6843Q1033,5DW ,RENEWABLE ENERGY ASIA LTD (FORMERLY SUPERIOR FASTENING TECH LTD),31-Mar-10,32,-22,10
524,GTI2010,BMG6843Q1033,5DW ,RENEWABLE ENERGY ASIA LTD (FORMERLY SUPERIOR FASTENING TECH LTD),31-Mar-09,42,-16,26
485,GTI2009,BMG6843Q1033,5DW ,SUPERIOR FASTENING TECH LTD,31-Mar-08,39,-11,28
396,GTI2013,BMG6843Q1033,5DX ,METAL COMPONENT ENGG LTD,31-Dec-12,37,-5,32
156,GTI2012,BMG6845B1046,5DX ,METAL COMPONENT ENGINEERING LTD,31-Dec-10,37,3,40
346,GTI2011,BMG6845B1046,5DX ,METAL COMPONENT ENGG LTD,31-Dec-09,31,-2,29
447,GTI2010,BMG6845B1046,5DX ,METAL COMPONENT ENGG LTD,31-Dec-08,31,-2,29
529,GTI2009,BMG6845B1046,5DX ,METAL COMPONENT ENGG LTD,31-Dec-07,39,-13,26
656,GTI2013,BMG6845B1046,5EB ,CFM HOLDINGS LIMITED,30-Jun-12,38,-29,9
177,GTI2012,BMG6900A1163,5EB ,CFM HLDGS LTD,30-Jun-11,42,-3,39
92,GTI2011,BMG6900A1163,5EB ,CFM HOLDINGS LIMITED,30-Jun-10,41,1,42
99,GTI2010,BMG6900A1163,5EB ,CFM HOLDINGS LIMITED,30-Jun-09,42,1,43
166,GTI2009,BMG6900A1163,5EB ,CFM HOLDINGS LIMITED,30-Jun-08,41,-2,39
302,GTI2013,BMG6900A1163,5EC ,ISR CAPITAL LIMITED,31-Dec-12,39,-3,36
611,GTI2012,BMG7000R1088,5EC ,ASIASONS WFG FINANCIAL LTD,31-Dec-10,28,-8,20
531,GTI2011,BMG7000R1088,5EC ,ASIASONS WFG FINANCIAL LTD. (FORMERLY WESTCOMB FINANCIAL GROUP LTD),31-Dec-09,31,-10,21
498,GTI2010,BMG7000R1088,5EC ,WESTCOMB FINANCIAL GROUP LTD,31-Dec-08,33,-6,27
558,GTI2009,BMG7000R1088,5EC ,WESTCOMB FINANCIAL GROUP LTD,31-Dec-07,36,-11,25
621,GTI2013,BMG7000R1088,5EF ,ADVENTUS HOLDINGS LIMITED,31-Dec-12,30,-10,20
410,GTI2012,BMG712311072,5EF ,ADVENTUS HLDGS LTD,31-Dec-10,33,-3,30
514,GTI2011,BMG712311072,5EF ,ADVENTUS HOLDINGS LIMITED,31-Dec-09,30,-8,22
599,GTI2010,BMG712311072,5EF ,ADVENTUS HOLDINGS LIMITED,31-Dec-08,27,-5,22
292,GTI2009,BMG712311072,5EF ,SNF CORPORATION LTD,31-Dec-07,37,-2,35
630,GTI2013,BMG7499U1099,5EG ,NEW LAKESIDE HOLDINGS LIMITED,30-Jun-12,23,-4,19
657,GTI2011,BMG7499U1099,5EG ,NEW LAKESIDE HOLDINGS LIMITED,.,26,-30,-4
543,GTI2010,BMG7499U1099,5EG ,NEW LAKESIDE HOLDINGS LIMITED,30-Jun-09,30,-5,25
228,GTI2009,BMG7499U1099,5EG ,NEW LAKESIDE HOLDINGS LIMITED,30-Jun-08,39,-2,37
544,GTI2013,BMG7499U1099,5EK ,ARMARDA GROUP LIMITED,31-Mar-12,34,-8,26
355,GTI2012,BMG8164G1024,5EK ,ARMARDA GROUP LTD,31-Dec-10,35,-3,32
407,GTI2011,BMG8164G1024,5EK ,ARMARDA GROUP LIMITED,31-Dec-09,32,-5,27
296,GTI2010,BMG8164G1024,5EK ,ARMARDA GROUP LIMITED,31-Dec-08,39,-5,34
463,GTI2009,BMG8164G1024,5EK ,ARMARDA GROUP LIMITED,31-Dec-07,37,-8,29
525,GTI2013,BMG8164G1024,5EL ,LASSETERS INTERNATIONAL HOLDINGS LIMITED,30-Jun-12,29,-2,27
317,GTI2012,BMG8169N1020,5EL ,LASSETERS INTERNATIONAL HLDGS LTD,30-Jun-11,30,3,33
325,GTI2011,BMG8169N1020,5EL ,LASSETERS INTL HOLDINGS LTD,30-Jun-10,35,-5,30
148,GTI2010,BMG8169N1020,5EL ,LASSETERS INTL HOLDINGS LTD,30-Jun-09,40,0,40
53,GTI2009,BMG8226U1071,5EL ,LASSETERS INTL HOLDINGS LTD,30-Jun-08,46,0,46
91,GTI2013,BMG8226U1071,5EN ,MIDAS HLDGS LIMITED,31-Dec-12,50,1,51
156,GTI2012,BMG8226U1071,5EN ,MIDAS HLDGS LTD,31-Dec-10,40,0,40
118,GTI2011,BMG8226U1071,5EN ,MIDAS HLDGS LIMITED,31-Dec-09,46,-5,41
72,GTI2010,BMG8226U1071,5EN ,MIDAS HLDGS LIMITED,31-Dec-08,50,-5,45
61,GTI2009,BMG857501263,5EN ,MIDAS HLDGS LIMITED,31-Dec-07,50,-5,45
84,GTI2013,BMG857501263,5ER ,BEST WORLD INTERNATIONAL LTD,31-Dec-12,51,1,52
66,GTI2012,BMG857501263,5ER ,BEST WORLD INTERNATIONAL LTD,31-Dec-10,50,0,50
85,GTI2011,BMG8584Y1057,5ER ,BEST WORLD INTERNATIONAL LTD,31-Dec-09,45,-2,43
267,GTI2010,BMG8584Y1057,5ER ,BEST WORLD INTERNATIONAL LTD,31-Dec-08,46,-11,35
196,GTI2009,BMG8584Y1057,5ER ,BEST WORLD INTERNATIONAL LTD,31-Dec-07,43,-5,38
503,GTI2013,BMG8584Y1396,5ET ,ASIASONS CAPITAL LIMITED,31-Dec-12,32,-4,28
602,GTI2012,BMG8584Y1396,5ET ,ASIASONS CAPITAL LTD,31-Dec-10,33,-12,21
604,GTI2011,BMG8585G1033,5ET ,ASIASONS CAPITAL LIMITED,31-Dec-09,27,-12,15
640,GTI2010,BMG8585G1033,5ET ,ASIASONS CAPITAL LIMITED,31-Dec-08,28,-12,16
463,GTI2009,BMG8585G1033,5ET ,ASIASONS CAPITAL LIMITED,31-Dec-07,31,-2,29
396,GTI2013,BMG8585G1033,5EV ,HOSEN GROUP LTD,31-Dec-12,32,0,32
410,GTI2012,BMG8585G1033,5EV ,HOSEN GROUP LTD,31-Dec-10,30,0,30
254,GTI2011,BMG8585U1027,5EV ,HOSEN GROUP LTD,31-Dec-09,33,0,33
468,GTI2010,BMG8585U1027,5EV ,HOSEN GROUP LTD,31-Dec-08,28,0,28
485,GTI2009,BMG8585U1027,5EV ,HOSEN GROUP LTD,31-Dec-07,30,-2,28
525,GTI2013,BMG8585U1027,5EW ,PAN ASIAN HOLDINGS LIMITED,31-Dec-12,29,-2,27
500,GTI2012,BMG8585U1027,5EW ,PAN ASIAN HLDGS LTD,31-Dec-10,26,0,26
479,GTI2011,BMG8609Q2510,5EW ,PAN ASIAN WATER SOLUTIONS LTD,31-Dec-09,32,-8,24
447,GTI2010,BMG8609Q2510,5EW ,PAN ASIAN WATER SOLUTIONS LTD,31-Dec-08,35,-6,29
70,GTI2009,BMG8609Q2510,5EW ,PAN ASIAN WATER SOLUTIONS LTD,31-Dec-07,44,0,44
430,GTI2013,BMG8609Q2510,5FA ,JEP HOLDINGS LTD.,31-Dec-12,30,1,31
410,GTI2012,BMG8609Q2510,5FA ,JEP HLDGS LTD,31-Dec-10,27,3,30
210,GTI2011,BMG8648Q1069,5FA ,JEP HOLDINGS (FORMERLY ALANTAC TECHNOLOGY LTD.),31-Dec-09,35,0,35
267,GTI2010,BMG8648Q1069,5FA ,ALANTAC TECHNOLOGY LTD.,31-Dec-08,35,0,35
505,GTI2009,BMG8648Q1069,5FA ,ALANTAC TECHNOLOGY LTD.,31-Dec-07,33,-6,27
326,GTI2013,BMG8648Q1069,5FD ,SWISSCO HOLDINGS LIMITED,31-Dec-12,35,0,35
156,GTI2012,BMG8648Q1069,5FD ,SWISSCO HLDGS LTD,31-Dec-10,34,6,40
174,GTI2010,BMG872571044,5FD ,C2O HOLDINGS LIMITED,28-Feb-09,38,1,39
53,GTI2009,BMG872571044,5FD ,C2O HOLDINGS LIMITED,29-Feb-08,45,1,46
396,GTI2013,BMG872571044,5FF ,MEDI-FLEX LIMITED,31-Aug-12,37,-5,32
565,GTI2012,BMG872571044,5FF ,MEDI-FLEX LTD,31-Aug-11,40,-17,23
531,GTI2011,BMG872571044,5FF ,MEDI-FLEX LIMITED,31-Aug-10,38,-17,21
129,GTI2010,BMG9112T1053,5FF ,MEDI-FLEX LIMITED,31-Aug-09,41,0,41
292,GTI2009,BMG9112T1053,5FF ,MEDI-FLEX LIMITED,31-Aug-08,35,0,35
185,GTI2013,BMG9112T1053,5FH ,ADVANCE SCT LIMITED,31-Dec-12,40,1,41
131,GTI2012,BMG9112T1053,5FH ,ADVANCE SCT LTD,31-Dec-10,46,-4,42
629,GTI2011,BMG9112T1053,5FH ,ADVANCE SCT LIMITED,31-Dec-09,37,-26,11
667,GTI2010,BMG9232V1054,5FH ,ADVANCE SCT LIMITED,31-Dec-08,33,-24,9
676,GTI2009,BMG9232V1054,5FH ,ADVANCE SCT LIMITED,31-Dec-07,37,-43,-6
302,GTI2013,BMG9232V1054,5FI ,ORIENTAL GROUP LTD.,31-Dec-12,41,-5,36
196,GTI2012,BMG9232V1054,5FI ,ORIENTAL FOOD (HLDGS) LTD,31-Dec-10,35,3,38
230,GTI2011,BMG9232V1054,5FI ,ORIENTAL FOOD (HOLDINGS) LTD.,31-Dec-09,31,3,34
498,GTI2010,BMG9316Y1084,5FI ,ORIENTAL FOOD (HOLDINGS) LTD.,31-Dec-08,24,3,27
407,GTI2009,BMG9316Y1084,5FI ,ORIENTAL FOOD (HOLDINGS) LTD.,31-Dec-07,30,1,31
567,GTI2011,BMG9316Y1084,5FK,CHINA FASHION HOLDINGS LIMITED,31-Dec-09,24,-6,18
417,GTI2010,BMG9316Y1084,5FK,CHINA FASHION HOLDINGS LIMITED,31-Dec-08,27,3,30
357,GTI2009,BMG9316Y1084,5FK,CHINA FASHION HOLDINGS LIMITED,31-Dec-07,32,1,33
503,GTI2013,BMG9643L1000,5FL ,FALCON ENERGY GROUP LIMITED,31-Dec-11,35,-7,28
115,GTI2012,BMG9643L1000,5FL ,FALCON ENERGY GROUP LTD,31-Dec-10,42,1,43
346,GTI2011,BMG9643L1000,5FL ,FALCON ENERGY GROUP LIMITED,31-Dec-09,31,-2,29
468,GTI2010,BMG9643L1000,5FL ,FALCON ENERGY GROUP LIMITED,31-Dec-08,28,0,28
185,GTI2013,BMG9643L1000,5FQ ,SELECT GROUP LIMITED,31-Dec-12,43,-2,41
156,GTI2012,BMG9891Y1012,5FQ ,SELECT GROUP LTD,31-Dec-10,40,0,40
186,GTI2011,BMG9891Y1012,5FQ ,SELECT GROUP LIMITED,31-Dec-09,41,-5,36
99,GTI2010,BMG9891Y1012,5FQ ,SELECT GROUP LIMITED,31-Dec-08,43,0,43
228,GTI2009,BMG9891Y1012,5FQ ,SELECT GROUP LIMITED,31-Dec-07,40,-3,37
566,GTI2013,BMG9891Y1012,5FR ,ETIKA INTERNATIONAL HLDGS LTD,30-Sep-12,32,-7,25
115,GTI2012,CNE1000007L2,5FR ,ETIKA INTERNATIONAL HLDGS LTD,30-Sep-11,37,6,43
210,GTI2011,CNE1000007L2,5FR ,ETIKA INTERNATIONAL HLDGS LTD,30-Sep-10,39,-4,35
323,GTI2010,CNE1000007L2,5FR ,ETIKA INTERNATIONAL HLDGS LTD,30-Sep-08,30,3,33
266,GTI2009,CNE1000007L2,5FR ,ETIKA INTERNATIONAL HLDGS LTD,30-Sep-07,35,1,36
544,GTI2013,CNE1000007L2,5FU,HARTAWAN HLDGS LTD,30-Jun-12,28,-2,26
666,GTI2012,CNE1000007M0,5FU,HARTAWAN HLDGS LTD,30-Jun-11,31,-22,9
659,GTI2011,CNE1000007M0,5FU,HARTAWAN HLDGS LTD,30-Jun-10,22,-32,-10
676,GTI2010,CNE1000007M0,5FU,HARTAWAN HLDGS LTD,30-Jun-09,28,-30,-2
558,GTI2009,CNE1000007M0,5FU,HARTAWAN HLDGS LTD,30-Jun-08,46,-21,25
302,GTI2013,CNE1000007M0,5FW ,LINAIR TECHNOLOGIES LIMITED,31-Dec-12,35,1,36
292,GTI2012,CNE100000924,5FW ,LINAIR TECHNOLOGIES LTD,31-Dec-10,33,1,34
230,GTI2011,CNE100000924,5FW ,LINAIR TECHNOLOGIES LIMITED,31-Dec-09,36,-2,34
543,GTI2010,CNE100000924,5FW ,LINAIR TECHNOLOGIES LIMITED,31-Dec-08,30,-5,25
228,GTI2009,CNE100000924,5FW ,LINAIR TECHNOLOGIES LIMITED,31-Dec-07,39,-2,37
503,GTI2013,CNE100000924,5FX ,NEW WAVE HOLDINGS LTD.,31-Mar-12,35,-7,28
533,GTI2012,Delisted,5FX ,NEW WAVE HLDGS LTD,31-Mar-11,24,1,25
514,GTI2011,Delisted,5FX ,NEW WAVE HOLDINGS LTD.,31-Mar-10,26,-4,22
498,GTI2010,Delisted,5FX ,NEW WAVE HOLDINGS LTD.,31-Mar-09,29,-2,27
529,GTI2009,Delisted,5FX ,NEW WAVE HOLDINGS LTD.,31-Mar-08,28,-2,26
230,GTI2013,Delisted,5GB ,SIIC ENVIRONMENT HOLDINGS LTD,31-Dec-12,39,0,39
379,GTI2012,Delisted,5GB ,ASIA WATER TECHNOLOGY LTD,31-Dec-10,40,-9,31
638,GTI2011,Delisted,5GB ,ASIA WATER TECHNOLOGY LTD.,31-Dec-09,34,-26,8
468,GTI2010,Delisted,5GB ,ASIA WATER TECHNOLOGY LTD.,31-Dec-08,46,-18,28
228,GTI2009,Delisted,5GB ,ASIA WATER TECHNOLOGY LTD.,31-Dec-07,37,0,37
132,GTI2013,Delisted,5GC ,CNA GROUP LTD,31-Dec-12,39,7,46
500,GTI2012,Delisted,5GC ,CNA GROUP LTD,31-Dec-10,38,-12,26
458,GTI2011,GB0043620292,5GC ,CNA GROUP LTD.,31-Dec-09,37,-12,25
196,GTI2010,GB0043620292,5GC ,CNA GROUP LTD.,31-Dec-08,40,-2,38
196,GTI2009,GB0043620292,5GC ,CNA GROUP LTD.,31-Dec-07,38,0,38
145,GTI2013,GB0043620292,5GD ,SUNPOWER GROUP LTD,31-Dec-12,42,3,45
220,GTI2012,HK0000035813,5GD ,SUNPOWER GROUP LTD,31-Dec-10,37,0,37
92,GTI2011,HK0000035813,5GD ,SUNPOWER GROUP LTD.,31-Dec-09,42,0,42
395,GTI2010,HK0000035813,5GD ,SUNPOWER GROUP LTD.,31-Dec-08,34,-3,31
292,GTI2009,HK0000035813,5GD ,SUNPOWER GROUP LTD.,31-Dec-07,40,-5,35
588,GTI2013,HK0000035813,5GF ,NICO STEEL HOLDINGS LIMITED,29-Feb-12,30,-7,23
436,GTI2012,ID1000099906,5GF ,NICO STEEL HLDGS LTD,28-Feb-11,31,-2,29
514,GTI2011,IL0010927254,5GF ,NICO STEEL HOLDINGS LIMITED,28-Feb-10,27,-5,22
468,GTI2010,IL0010927254,5GF ,NICO STEEL HOLDINGS LIMITED,28-Feb-09,30,-2,28
266,GTI2009,IL0010927254,5GF ,NICO STEEL HOLDINGS LIMITED,29-Feb-08,41,-5,36
396,GTI2013,IL0010927254,5GI ,INTERRA RESOURCES LIMITED,31-Dec-12,43,-11,32
317,GTI2012,IL0010927254,5GI ,INTERRA RESOURCES LTD,31-Dec-10,33,0,33
165,GTI2011,KR7028670008,5GI ,INTERRA RESOURCES LIMITED,31-Dec-09,39,-2,37
174,GTI2010,KR7028670008,5GI ,INTERRA RESOURCES LIMITED,31-Dec-08,41,-2,39
111,GTI2009,KR7028670008,5GI ,INTERRA RESOURCES LIMITED,31-Dec-07,44,-3,41
302,GTI2013,KR7028670008,5GJ ,AUSGROUP LIMITED,30-Jun-12,49,-13,36
105,GTI2012,KR7028670008,5GJ ,AUSGROUP LTD,30-Jun-11,46,-2,44
56,GTI2011,KYG1745C1042,5GJ ,AUSGROUP LIMITED,30-Jun-10,47,1,48
43,GTI2010,KYG1745C1042,5GJ ,AUSGROUP LIMITED,30-Jun-09,51,-2,49
37,GTI2009,KYG1745C1042,5GJ ,AUSGROUP LIMITED,30-Jun-08,50,0,50
396,GTI2013,KYG1745C1042,5GZ ,AA GROUP HOLDINGS LTD,31-Dec-12,34,-2,32
379,GTI2012,KYG211001212,5GZ ,AA GROUP HLDGS LTD,31-Dec-10,31,0,31
325,GTI2011,KYG211001212,5GZ ,AA GROUP HOLDINGS LTD.,31-Dec-09,32,-2,30
468,GTI2010,KYG211001212,5GZ ,AA GROUP HOLDINGS LTD.,31-Dec-08,33,-5,28
529,GTI2009,KYG211001212,5GZ ,AA GROUP HOLDINGS LTD.,31-Dec-07,29,-3,26
162,GTI2013,KYG211001212,5HC ,NTEGRATOR INTERNATIONAL LTD,31-Dec-12,45,-2,43
268,GTI2012,KYG211051043,5HC ,NTEGRATOR INTERNATIONAL LTD,31-Dec-10,40,-5,35
129,GTI2011,KYG211051043,5HC ,NTEGRATOR INTERNATIONAL LTD,31-Dec-09,45,-5,40
267,GTI2010,KYG211051043,5HC ,NTEGRATOR INTERNATIONAL LTD,31-Dec-08,38,-3,35
505,GTI2009,KYG2111N1043,5HC ,NTEGRATOR INTERNATIONAL LTD,31-Dec-07,33,-6,27
353,GTI2013,KYG2111N1043,5HG ,ONIONTECH LIMITED,31-Dec-12,36,-2,34
500,GTI2012,KYG2111N1043,5HG ,ONIONTECH LTD,31-Dec-10,28,-2,26
514,GTI2011,KYG2111N1043,5HG ,ONIONTECH LIMITED,31-Dec-09,27,-5,22
608,GTI2010,KYG2111N1043,5HG ,ONIONTECH LIMITED,31-Dec-08,27,-6,21
615,GTI2009,KYG2112C1078,5HG ,ONIONTECH LIMITED,31-Dec-07,29,-8,21
115,GTI2013,KYG2112C1078,5HH ,HLN TECHNOLOGIES LIMITED,31-Dec-12,47,1,48
131,GTI2012,KYG2112C1078,5HH ,HLN TECHNOLOGIES LTD,31-Dec-10,42,0,42
149,GTI2011,KYG211721041,5HH ,HLN TECHNOLOGIES LIMITED,31-Dec-09,38,0,38
352,GTI2010,KYG211721041,5HH ,HLN TECHNOLOGIES LIMITED,31-Dec-08,35,-3,32
407,GTI2009,KYG211721041,5HH ,HLN TECHNOLOGIES LIMITED,31-Dec-07,36,-5,31
544,GTI2013,KYG211721041,5HJ ,CITYNEON HOLDINGS LIMITED,31-Dec-12,32,-6,26
565,GTI2012,KYG211721041,5HJ ,CITYNEON HLDGS LTD,31-Dec-10,35,-12,23
588,GTI2011,KYG215681035,5HJ ,CITYNEON HOLDINGS LIMITED,31-Dec-09,28,-12,16
524,GTI2010,KYG215681035,5HJ ,CITYNEON HOLDINGS LIMITED,31-Dec-08,29,-3,26
463,GTI2009,KYG215681035,5HJ ,CITYNEON HOLDINGS LIMITED,31-Dec-07,31,-2,29
207,GTI2013,KYG215681035,5HT ,COMMUNICATION DESIGN INTL LTD,30-Jun-12,39,1,40
220,GTI2012,KYG215681035,5HT ,COMMUNICATION DESIGN INTERNATIONAL LTD,30-Jun-11,34,3,37
165,GTI2011,KYG215691273,5HT ,COMMUNICATION DESIGN INTL LTD,30-Jun-10,36,1,37
586,GTI2010,KYG229811156,5HT ,COMMUNICATION DESIGN INTL LTD,30-Jun-09,38,-15,23
574,GTI2009,KYG229811156,5HT ,COMMUNICATION DESIGN INTL LTD,30-Jun-08,26,-2,24
566,GTI2013,KYG229811156,5HV ,METAX ENGINEERING CORP LIMITED,30-Jun-12,33,-8,25
410,GTI2012,KYG229811156,5HV ,METAX ENGINEERING CORP LTD,30-Jun-11,33,-3,30
210,GTI2011,KYG229811156,5HV ,METAX ENGINEERING CORP LIMITED,30-Jun-10,42,-7,35
235,GTI2010,KYG379151080,5HV ,METAX ENGINEERING CORP LIMITED,30-Jun-09,36,0,36
111,GTI2009,KYG379151080,5HV ,METAX ENGINEERING CORP LIMITED,30-Jun-08,41,0,41
132,GTI2013,KYG379151080,5HW ,SCORPIO EAST HOLDINGS LTD.,30-Apr-12,46,0,46
567,GTI2011,KYG379151080,5HW ,SCORPIO EAST HOLDINGS LTD.,30-Apr-10,34,-16,18
352,GTI2010,KYG379151080,5HW ,SCORPIO EAST HOLDINGS LTD.,30-Apr-09,38,-6,32
266,GTI2009,KYG6074A1085,5HW ,SCORPIO EAST HOLDINGS LTD.,30-Apr-08,36,0,36
132,GTI2013,KYG6074A1085,5IA ,Advanced Holdings Ltd.,31-Dec-12,46,0,46
92,GTI2012,KYG730441022,5IA ,ADVANCED HLDGS LTD,31-Dec-10,45,0,45
92,GTI2011,KYG730441022,5IA ,ADVANCED HOLDINGS LTD.,31-Dec-09,44,-2,42
296,GTI2010,KYG8064W1087,5IA ,ADVANCED HOLDINGS LTD.,31-Dec-08,39,-5,34
574,GTI2009,KYG8064W1087,5IA ,ADVANCED HOLDINGS LTD.,31-Dec-07,29,-5,24
544,GTI2013,KYG8064W1087,5IB ,ALBEDO LIMITED,31-Dec-12,38,-12,26
633,GTI2012,KYG8064W1087,5IB ,ALBEDO LTD,31-Dec-10,29,-11,18
531,GTI2011,KYG8064W1087,5IB ,ALBEDO LIMITED,31-Dec-09,34,-13,21
524,GTI2010,KYG919821010,5IB ,ALBEDO LIMITED,31-Dec-08,37,-11,26
442,GTI2009,KYG919821010,5IB ,ALBEDO LIMITED,31-Dec-07,43,-13,30
273,GTI2013,KYG919821010,5IC ,SING HOLDINGS LIMITED,31-Dec-12,37,0,37
131,GTI2012,KYG919821010,5IC ,SING HLDGS LTD,31-Dec-10,39,3,42
165,GTI2011,KYG919821010,5IC ,SING HOLDINGS LIMITED,31-Dec-09,42,-5,37
216,GTI2010,MU0117U00026,5IC ,SING HOLDINGS LIMITED,31-Dec-08,37,0,37
70,GTI2009,MU0117U00026,5IC ,SING HOLDINGS LIMITED,31-Dec-07,44,0,44
60,GTI2013,MU0117U00026,5IE ,LORENZO INTERNATIONAL LIMITED,31-Dec-12,51,8,59
66,GTI2012,MU0117U00026,5IE ,LORENZO INTERNATIONAL LTD,31-Dec-10,46,4,50
377,GTI2011,MU0117U00026,5IE ,LORENZO INTERNATIONAL LIMITED,31-Dec-09,35,-7,28
174,GTI2010,SG0502000029,5IE ,LORENZO INTERNATIONAL LIMITED,31-Dec-08,41,-2,39
140,GTI2009,SG0502000029,5IE ,LORENZO INTERNATIONAL LIMITED,31-Dec-07,42,-2,40
230,GTI2013,SG0502000029,5IF ,NATURAL COOL HOLDINGS LIMITED,31-Dec-12,46,-7,39
355,GTI2012,SG0502000029,5IF ,NATURAL COOL HLDGS LTD,31-Dec-10,34,-2,32
186,GTI2011,SG0502000029,5IF ,NATURAL COOL HOLDINGS LIMITED,31-Dec-09,43,-7,36
174,GTI2010,SG0504000043,5IF ,NATURAL COOL HOLDINGS LIMITED,31-Dec-08,41,-2,39
140,GTI2009,SG0504000043,5IF ,NATURAL COOL HOLDINGS LIMITED,31-Dec-07,45,-5,40
207,GTI2013,SG0504000043,5IG ,GALLANT VENTURE LTD,31-Dec-12,41,-1,40
115,GTI2012,SG0504000043,5IG ,GALLANT VENTURE LTD,31-Dec-10,42,1,43
149,GTI2011,SG0504000043,5IG ,GALLANT VENTURE LTD.,31-Dec-09,42,-4,38
99,GTI2010,SG0505000059,5IG ,GALLANT VENTURE LTD.,31-Dec-08,42,1,43
140,GTI2009,SG0505000059,5IG ,GALLANT VENTURE LTD.,31-Dec-07,42,-2,40
207,GTI2013,SG0505000059,5IM ,GMG GLOBAL LTD,31-Dec-12,40,0,40
268,GTI2012,SG0505000059,5IM ,GMG GLOBAL LTD,31-Dec-10,35,0,35
149,GTI2011,SG0505000059,5IM ,GMG GLOBAL LTD,31-Dec-09,41,-3,38
352,GTI2010,SG0507000073,5IM ,GMG GLOBAL LTD,31-Dec-08,38,-6,32
529,GTI2009,SG0507000073,5IM ,GMG GLOBAL LTD,31-Dec-07,31,-5,26
77,GTI2013,SG0507000073,5JK ,HIAP HOE LIMITED,31-Dec-12,56,-3,53
196,GTI2012,SG0507000073,5JK ,HIAP HOE LTD,31-Dec-10,46,-8,38
118,GTI2011,SG0507000073,5JK ,HIAP HOE LIMITED,31-Dec-09,52,-11,41
115,GTI2010,SG0508000080,5JK ,HIAP HOE LIMITED,31-Dec-08,48,-6,42
292,GTI2009,SG0508000080,5JK ,HIAP HOE LIMITED,31-Dec-07,43,-8,35
154,GTI2013,SG0508000080,5JS ,INDOFOOD AGRI RESOURCES LTD,31-Dec-12,46,-2,44
51,GTI2012,SG0508000080,5JS ,INDOFOOD AGRI RESOURCES LTD,31-Dec-10,53,0,53
56,GTI2011,SG0508000080,5JS ,INDOFOOD AGRI RESOURCES LTD.,31-Dec-09,50,-2,48
64,GTI2010,SG0519000160,5JS ,INDOFOOD AGRI RESOURCES LTD.,31-Dec-08,48,-2,46
61,GTI2009,SG0519000160,5JS ,INDOFOOD AGRI RESOURCES LTD.,31-Dec-07,50,-5,45
292,GTI2012,SG0519000160,5JT,KINERGY LTD,31-Dec-10,37,-3,34
254,GTI2011,SG0519000160,5JT,KINERGY LTD.,31-Dec-09,36,-3,33
196,GTI2010,SG0519000160,5JT,KINERGY LTD.,31-Dec-08,38,0,38
228,GTI2009,SG0525000196,5JT,KINERGY LTD.,31-Dec-07,42,-5,37
317,GTI2012,SG0525000196,5JY,HUP SOON GLOBAL CORP LTD,31-Dec-10,42,-9,33
165,GTI2011,SG0525000196,5JY,HUP SOON GLOBAL CORP LTD,31-Dec-09,46,-9,37
395,GTI2010,SG0525000196,5JY,HUP SOON GLOBAL CORP LTD,31-Dec-08,43,-12,31
97,GTI2009,SG0525000196,5JY,HUP SOON GLOBAL CORP LTD,31-Dec-07,47,-5,42
503,GTI2013,SG0529000218,5KH ,TRAVELITE HOLDINGS LTD.,31-Mar-12,33,-5,28
196,GTI2012,SG0529000218,5KH ,TRAVELITE HLDGS LTD,31-Mar-11,38,0,38
377,GTI2011,SG0529000218,5KH ,TRAVELITE HOLDINGS LTD.,31-Mar-10,35,-7,28
468,GTI2010,SG0531000230,5KH ,TRAVELITE HOLDINGS LTD.,31-Mar-09,30,-2,28
574,GTI2009,SG0531000230,5KH ,TRAVELITE HOLDINGS LTD.,31-Mar-08,26,-2,24
373,GTI2013,SG0531000230,5KI ,SOUP RESTAURANT GROUP LIMITED,31-Dec-12,45,-12,33
196,GTI2012,SG0531000230,5KI ,SOUP RESTAURANT GROUP LTD,31-Dec-10,35,3,38
230,GTI2011,SG0531000230,5KI ,SOUP RESTAURANT GROUP LIMITED,31-Dec-09,32,2,34
216,GTI2010,SG0532000247,5KI ,SOUP RESTAURANT GROUP LIMITED,31-Dec-08,33,4,37
383,GTI2009,SG0532000247,5KI ,SOUP RESTAURANT GROUP LIMITED,31-Dec-07,37,-5,32
450,GTI2013,SG0532000247,5KK ,CHINA YONGSHENG LIMITED,31-Dec-12,42,-12,30
483,GTI2012,SG0532000247,5KK ,CHINA YONGSHENG LTD,31-Dec-10,43,-16,27
611,GTI2011,SG0532000247,5KK ,CHINA YONGSHENG LIMITED,31-Dec-09,35,-21,14
662,GTI2010,SG0533000253,5KK ,CHINA YONGSHENG LIMITED,31-Dec-08,32,-21,11
485,GTI2009,SG0533000253,5KK ,CHINA YONGSHENG LIMITED (FORMERLY GLOBAL ARIEL LTD),31-Dec-07,33,-5,28
273,GTI2013,SG0533000253,5KT ,FUJIAN ZHENYUN PLAS IND CO LTD,31-Dec-12,40,-3,37
292,GTI2012,SG0533000253,5KT ,FUJIAN ZHENYUN PLASTIC INDUSTRY CO LTD,31-Dec-10,44,-10,34
588,GTI2011,SG0533000253,5KT ,FUJIAN ZHENYUN PLAS IND CO LTD,31-Dec-09,25,-9,16
599,GTI2010,SG0534000260,5KT ,FUJIAN ZHENYUN PLAS IND CO LTD,31-Dec-08,27,-5,22
591,GTI2009,SG0534000260,5KT ,FUJIAN ZHENYUN PLAS IND CO LTD,31-Dec-07,28,-5,23
663,GTI2013,SG0534000260,5KU ,EASTERN HOLDINGS LTD,31-Mar-12,18,-22,-4
622,GTI2012,SG0534000260,5KU ,EASTERN HLDGS LTD,31-Mar-11,18,1,19
567,GTI2011,SG0534000260,5KU ,EASTERN HOLDINGS LTD,31-Mar-10,21,-3,18
620,GTI2010,SG0535000277,5KU ,EASTERN HOLDINGS LTD,31-Mar-09,23,-3,20
558,GTI2009,SG0535000277,5KU ,EASTERN HOLDINGS LTD,31-Mar-08,25,0,25
566,GTI2013,SG0535000277,5KX,ELEKTROMOTIVE GROUP LIMITED,31-Mar-12,44,-19,25
242,GTI2012,SG0535000277,5KX,ELEKTROMOTIVE GROUP LTD,31-Mar-11,38,-2,36
407,GTI2011,SG0535000277,5KX,THE LEXICON GROUP LIMITED,31-Mar-10,34,-7,27
174,GTI2010,SG0539000299,5KX,THE LEXICON GROUP LIMITED,31-Mar-09,44,-5,39
654,GTI2009,SG0539000299,5KX,THE LEXICON GROUP LIMITED,31-Mar-08,40,-25,15
450,GTI2013,SG0539000299,5LE ,SITRA HOLDINGS (INTL) LIMITED,31-Dec-12,29,1,30
115,GTI2012,SG0539000299,5LE ,SITRA HLDGS (INTERNATIONAL) LTD,31-Dec-10,40,3,43
377,GTI2011,SG0539000299,5LE ,SITRA HOLDINGS (INTL) LIMITED,31-Dec-09,27,1,28
196,GTI2010,SG0542000328,5LE ,SITRA HOLDINGS (INTL) LIMITED,31-Dec-08,40,-2,38
407,GTI2009,SG0542000328,5LE ,SITRA HOLDINGS (INTL) LIMITED,31-Dec-07,36,-5,31
196,GTI2012,SG0542000328,5LU,ROKKO HLDGS LTD,31-Dec-10,35,3,38
281,GTI2011,SG0542000328,5LU,ROKKO HOLDINGS LTD.,31-Dec-09,34,-2,32
296,GTI2010,SG0542000328,5LU,ROKKO HOLDINGS LTD.,31-Dec-08,36,-2,34
485,GTI2009,SG0543000335,5LU,ROKKO HOLDINGS LTD.,31-Dec-07,33,-5,28
353,GTI2013,SG0543000335,5LY ,MARCO POLO MARINE LTD.,30-Sep-12,36,-2,34
455,GTI2012,SG0543000335,5LY ,MARCO POLO MARINE LTD,30-Sep-11,33,-5,28
325,GTI2011,SG0543000335,5LY ,MARCO POLO MARINE LTD.,30-Sep-10,34,-4,30
352,GTI2010,SG0543000335,5LY ,MARCO POLO MARINE LTD.,30-Sep-08,34,-2,32
166,GTI2009,SG0544000342,5LY ,MARCO POLO MARINE LTD.,30-Sep-07,41,-2,39
480,GTI2013,SG0544000342,5MC ,BENG KUANG MARINE LIMITED,31-Dec-12,33,-4,29
355,GTI2012,SG0544000342,5MC ,BENG KUANG MARINE LTD,31-Dec-10,34,-2,32
407,GTI2011,SG0544000342,5MC ,BENG KUANG MARINE LIMITED,31-Dec-09,31,-4,27
352,GTI2010,SG0544000342,5MC ,BENG KUANG MARINE LIMITED,31-Dec-08,37,-5,32
266,GTI2009,SG0545000358,5MC ,BENG KUANG MARINE LIMITED,31-Dec-07,41,-5,36
273,GTI2013,SG0545000358,5MD ,SOON LIAN HOLDINGS LIMITED,31-Dec-12,41,-4,37
500,GTI2012,SG0545000358,5MD ,SOON LIAN HLDGS LTD,31-Dec-10,31,-5,26
458,GTI2011,SG0545000358,5MD ,SOON LIAN HOLDINGS LIMITED,31-Dec-09,32,-7,25
352,GTI2010,SG0545000358,5MD ,SOON LIAN HOLDINGS LIMITED,31-Dec-08,34,-2,32
383,GTI2009,SG0558000436,5MD ,SOON LIAN HOLDINGS LIMITED,31-Dec-07,37,-5,32
544,GTI2013,SG0558000436,5ME ,EZION HOLDINGS LIMITED,31-Dec-12,39,-13,26
242,GTI2012,SG0558000436,5ME ,EZION HLDGS LTD,31-Dec-10,41,-5,36
458,GTI2011,SG0558000436,5ME ,EZION HOLDINGS LIMITED,31-Dec-09,35,-10,25
267,GTI2010,SG0558000436,5ME ,EZION HOLDINGS LIMITED,31-Dec-08,40,-5,35
196,GTI2009,SG0560000457,5ME ,EZION HOLDINGS LIMITED,31-Dec-07,43,-5,38
273,GTI2013,SG0560000457,5ML ,OLD CHANG KEE LTD.,31-Mar-12,39,-2,37
115,GTI2012,SG0560000457,5ML ,OLD CHANG KEE LTD,31-Dec-10,37,6,43
230,GTI2011,SG0560000457,5ML ,OLD CHANG KEE LTD.,31-Dec-09,28,6,34
235,GTI2010,SG0560000457,5ML ,OLD CHANG KEE LTD.,31-Dec-08,32,4,36
463,GTI2009,SG0561000464,5ML ,OLD CHANG KEE LTD.,31-Dec-07,29,0,29
480,GTI2013,SG0561000464,5MM ,SKY ONE HOLDINGS LIMITED,31-Mar-12,34,-5,29
379,GTI2012,SG0561000464,5MM ,SKY ONE HLDGS LTD,31-Mar-11,34,-3,31
377,GTI2011,SG0561000464,5MM ,SKY ONE HOLDINGS LIMITED,31-Mar-10,33,-5,28
468,GTI2010,SG0561000464,5MM ,SKY ONE HOLDINGS LIMITED,31-Mar-09,33,-5,28
383,GTI2009,SG0564006450,5MM ,SKY ONE HOLDINGS LIMITED,31-Mar-08,32,0,32
396,GTI2013,SG0564006450,5MQ ,EPICENTRE HOLDINGS LIMITED,30-Jun-12,31,1,32
177,GTI2012,SG0564006450,5MQ ,EPICENTRE HLDGS LTD,30-Jun-11,36,3,39
281,GTI2011,SG0564006450,5MQ ,EPICENTRE HOLDINGS LIMITED (FORMERLY AFOR LIMITED),30-Jun-10,33,-1,32
417,GTI2010,SG0564006450,5MQ ,AFOR LIMITED,30-Jun-09,33,-3,30
529,GTI2009,SG0568007405,5MQ ,AFOR LIMITED,30-Jun-08,31,-5,26
302,GTI2013,SG0568007405,5MS ,MEMSTAR TECHNOLOGY LTD.,30-Jun-12,36,0,36
268,GTI2012,SG0568007405,5MS ,MEMSTAR TECHNOLOGY LTD,30-Jun-11,38,-3,35
210,GTI2011,SG0568007405,5MS ,MEMSTAR TECHNOLOGY LTD.,30-Jun-10,38,-3,35
216,GTI2010,SG0568007405,5MS ,MEMSTAR TECHNOLOGY LTD.,30-Jun-09,37,0,37
140,GTI2009,SG0569007446,5MS ,MEMSTAR TECHNOLOGY LTD.,30-Jun-08,43,-3,40
77,GTI2013,SG0569007446,5MZ ,KINGSMEN CREATIVES LTD,31-Dec-12,58,-5,53
131,GTI2012,SG0569007446,5MZ ,KINGSMEN CREATIVES LTD,31-Dec-10,42,0,42
118,GTI2011,SG0569007446,5MZ ,KINGSMEN CREATIVES LTD,31-Dec-09,43,-2,41
99,GTI2010,SG0569007446,5MZ ,KINGSMEN CREATIVES LTD,31-Dec-08,45,-2,43
37,GTI2009,SG0581008505,5MZ ,KINGSMEN CREATIVES LTD,31-Dec-07,49,1,50
51,GTI2013,SG0581008505,5NF ,MENCAST HOLDINGS LTD,31-Dec-12,56,6,62
55,GTI2012,SG0581008505,5NF ,MENCAST HLDGS LTD,31-Dec-10,52,0,52
52,GTI2011,SG0581008505,5NF ,MENCAST HOLDINGS LTD.,31-Dec-09,49,0,49
267,GTI2010,SG0581008505,5NF ,MENCAST HOLDINGS LTD.,31-Dec-08,35,0,35
353,GTI2013,SG0584008601,5NG ,HEALTHWAY MEDICAL CORP LTD,31-Dec-12,44,-10,34
379,GTI2012,SG0584008601,5NG ,HEALTHWAY MEDICAL CORP LTD,31-Dec-10,39,-8,31
186,GTI2011,SG0584008601,5NG ,HEALTHWAY MEDICAL CORP LTD,31-Dec-09,35,1,36
498,GTI2010,SG0584008601,5NG ,HEALTHWAY MEDICAL CORP LTD,31-Dec-08,27,0,27
108,GTI2013,SG0584008601,5NH ,ST. JAMES HOLDINGS LIMITED,30-Jun-12,46,3,49
131,GTI2012,SG0964000491,5NH ,ST. JAMES HLDGS LTD,30-Jun-11,39,3,42
85,GTI2011,SG0964000491,5NH ,ST. JAMES HOLDINGS LIMITED,30-Jun-10,40,3,43
57,GTI2010,SG0964000491,5NH ,ST. JAMES HOLDINGS LIMITED,30-Jun-09,44,3,47
140,GTI2009,SG0964000491,5NH ,ST. JAMES HOLDINGS LIMITED,30-Jun-08,37,3,40
108,GTI2013,SG0964000491,5NK ,ARTIVISION TECHNOLOGIES LTD.,31-Mar-12,51,-2,49
317,GTI2012,SG1A01000524,5NK ,ARTIVISION TECHNOLOGIES LTD,31-Mar-11,39,-6,33
230,GTI2011,SG1A01000524,5NK ,ARTIVISION TECHNOLOGIES LTD.,31-Mar-10,41,-7,34
267,GTI2010,SG1A01000524,5NK ,ARTIVISION TECHNOLOGIES LTD.,31-Mar-09,37,-2,35
396,GTI2013,SG1A01000524,5NL ,TRITECH GROUP LIMITED,31-Mar-12,39,-7,32
455,GTI2012,SG1A35000706,5NL ,TRITECH GROUP LTD,31-Mar-11,33,-5,28
230,GTI2011,SG1A35000706,5NL ,TRITECH GROUP LIMITED,31-Mar-10,38,-4,34
235,GTI2010,SG1A35000706,5NL ,TRITECH GROUP LIMITED,31-Mar-09,35,1,36
503,GTI2013,SG1A35000706,5NV ,CHASEN HOLDINGS LIMITED,31-Mar-12,33,-5,28
268,GTI2012,SG1A35000706,5NV ,CHASEN HLDGS LTD,31-Mar-11,43,-8,35
611,GTI2011,SG1A43000730,5NV ,CHASEN HOLDINGS LIMITED,31-Mar-10,33,-19,14
668,GTI2010,SG1A43000730,5NV ,CHASEN HOLDINGS LIMITED,31-Mar-09,31,-23,8
463,GTI2009,SG1A43000730,5NV ,CHASEN HOLDINGS LIMITED,31-Mar-08,31,-2,29
525,GTI2013,SG1A43000730,5OC ,KOYO INTERNATIONAL LIMITED,31-Dec-12,27,0,27
500,GTI2012,SG1A43000730,5OC ,KOYO INTERNATIONAL LTD,31-Dec-10,28,-2,26
346,GTI2011,SG1A48000743,5OC ,KOYO INTERNATIONAL LIMITED (FORMERLY CYBER VILLAGE HOLDINGS LIMITED),31-Dec-09,34,-5,29
620,GTI2010,SG1A48000743,5OC ,KOYO INTERNATIONAL LIMITED,31-Dec-08,23,-3,20
154,GTI2013,SG1A48000743,5OF ,WESTMINSTER TRAVEL LIMITED,30-Jun-12,40,4,44
46,GTI2012,SG1A48000743,5OF ,WESTMINSTER TRAVEL LTD,30-Jun-11,51,3,54
129,GTI2011,SG1A48000743,5OF ,WESTMINSTER TRAVEL LIMITED,30-Jun-10,39,1,40
352,GTI2010,SG1A49000759,5OF ,WESTMINSTER TRAVEL LIMITED,30-Jun-09,34,-2,32
207,GTI2013,SG1A49000759,5OI ,JAPAN FOODS HOLDING LTD.,31-Mar-12,47,-7,40
355,GTI2012,SG1A49000759,5OI ,JAPAN FOODS HLDG LTD,31-Mar-11,37,-5,32
346,GTI2011,SG1A49000759,5OI ,JAPAN FOODS HOLDING LTD.,31-Mar-10,36,-7,29
564,GTI2010,SG1A49000759,5OI ,JAPAN FOODS HOLDING LTD.,31-Mar-09,26,-2,24
207,GTI2013,SG1A67000830,5OQ ,TEHO INTERNATIONAL INC LTD.,30-Jun-12,39,1,40
355,GTI2012,SG1A67000830,5OQ ,TEHO INTERNATIONAL INC LTD,30-Jun-11,35,-3,32
544,GTI2013,SG1A67000830,5OR ,HEATEC JIETONG HOLDINGS LTD,31-Dec-12,32,-6,26
565,GTI2012,SG1A67000830,5OR ,HEATEC JIETONG HLDGS LTD,31-Dec-10,26,-3,23
430,GTI2013,SG1A67000830,5OS ,JUBILEE INDUSTRIES HLDGS LTD,31-Dec-12,38,-7,31
455,GTI2012,SG1A77000903,5OS ,JLJ HLDGS LTD,31-Dec-10,30,-2,28
430,GTI2013,SG1A77000903,5OT ,SINGAPORE MEDICAL GROUP LTD,31-Dec-12,35,-4,31
292,GTI2012,SG1A77000903,5OT ,SINGAPORE MEDICAL GROUP LTD,31-Dec-10,34,0,34
84,GTI2013,SG1A77000903,5OU ,CHINA ENVIRONMENT LTD,31-Dec-12,43,9,52
149,GTI2012,SG1A77000903,5OU ,CHINA ENVIRONMENT LTD,31-Dec-10,38,3,41
377,GTI2011,SG1A82000914,5OU ,CHINA ENVIRONMENT LTD (FORMERLY GATES ELECTRONICS LTD),31-Dec-09,27,1,28
498,GTI2010,SG1A82000914,5OU ,CHINA ENVIRONMENT LTD (Formerly Gates Electronics Ltd),30-Jun-09,27,0,27
442,GTI2009,SG1A82000914,5OU ,GATES ELECTRONICS LIMITED,30-Jun-08,29,1,30
273,GTI2013,SG1A82000914,5OX ,MARY CHIA HOLDINGS LIMITED,31-Mar-12,36,1,37
483,GTI2012,SG1A82000914,5OX ,MARY CHIA HLDGS LTD,31-Dec-10,26,1,27
326,GTI2013,SG1A83000921,5OY ,LATITUDE TREE INTL GROUP LTD.,30-Jun-12,35,0,35
196,GTI2012,SG1A83000921,5OY ,LATITUDE TREE INTERNATIONAL GROUP LTD,30-Jun-11,35,3,38
76,GTI2011,SG1A83000921,5OY ,LATITUDE TREE INTL GROUP LTD.,30-Jun-10,38,6,44
430,GTI2013,SG1A83000921,5PC ,GOODLAND GROUP LIMITED,30-Sep-12,33,-2,31
436,GTI2012,SG1A83000921,5PC ,GOODLAND GROUP LTD,30-Sep-11,28,1,29
346,GTI2011,SG1A85006306,5PC ,GOODLAND GROUP LIMITED,30-Sep-10,28,1,29
503,GTI2013,SG1A85006306,5PD ,HENGYANG PETROCHEM LOG LIMITED,31-Dec-12,31,-3,28
436,GTI2012,SG1A85006306,5PD ,HENGYANG PETROCHEMICAL LOGISTICS LTD,31-Dec-10,31,-2,29
230,GTI2013,SG1A85006306,5PF ,JASON MARINE GROUP LIMITED,31-Mar-12,38,1,39
410,GTI2012,SG1A85006306,5PF ,JASON MARINE GROUP LTD,31-Dec-10,27,3,30
450,GTI2013,SG1A98006814,5PI ,PLATO CAPITAL LIMITED,31-Dec-12,30,0,30
379,GTI2012,SG1A98006814,5PI ,PLATO CAPITAL LTD,30-Jun-11,27,4,31
346,GTI2011,SG1A98006814,5PI ,PLATO CAPITAL LIMITED,30-Jun-10,28,1,29
498,GTI2010,SG1A98006814,5PI ,PLATO CAPITAL LIMITED,30-Jun-09,29,-2,27
505,GTI2009,SG1B05007508,5PI ,PLATO CAPITAL LIMITED,30-Jun-08,29,-2,27
91,GTI2013,SG1B05007508,5PL ,SBI OFFSHORE LIMITED,31-Dec-12,51,0,51
92,GTI2012,SG1B05007508,5PL ,SBI OFFSHORE LTD,31-Dec-10,42,3,45
450,GTI2013,SG1B05007508,5PO ,HIAP TONG CORPORATION LTD.,31-Mar-12,34,-4,30
156,GTI2012,SG1B06007705,5PO ,HIAP TONG CORP LTD,31-Mar-11,37,3,40
450,GTI2013,SG1B06007705,5PP,HAFARY HOLDINGS LIMITED,30-Jun-12,35,-5,30
500,GTI2012,SG1B06007705,5PP,HAFARY HLDGS LTD,30-Jun-11,34,-8,26
326,GTI2013,SG1B06007705,5QR ,MANN SENG METAL INTL LIMITED,31-Dec-12,36,-1,35
355,GTI2012,SG1B06007705,5QR ,MANN SENG METAL INTERNATIONAL LTD,31-Dec-10,31,1,32
578,GTI2013,SG1B09007736,5QT ,YHM GROUP LIMITED,31-Dec-12,32,-8,24
622,GTI2012,SG1B09007736,5QT ,CHINA ENERSAVE LTD,31-Dec-10,35,-16,19
544,GTI2011,SG1B09007736,5QT ,CHINA ENERSAVE LTD,31-Dec-09,33,-13,20
196,GTI2010,SG1B09007736,5QT ,CHINA ENERSAVE LTD,31-Dec-08,41,-3,38
292,GTI2009,SG1B09007736,5QT ,CHINA ENERSAVE LTD,31-Dec-07,38,-3,35
373,GTI2013,SG1B10007741,5QY ,NET PACIFIC FIN HLDGS LTD,31-Dec-12,37,-4,33
483,GTI2012,SG1B10007741,5QY ,NET PACIFIC FINANCIAL HLDGS LTD,31-Dec-10,29,-2,27
430,GTI2011,SG1B10007741,5QY ,NET PACIFIC FIN HLDGS LTD (FORMERLY K PLAS HOLDINGS LIMITED),31-Dec-09,34,-8,26
323,GTI2010,SG1B10007741,5QY ,K PLAS HOLDINGS LIMITED,31-Dec-08,33,0,33
97,GTI2009,SG1B10007741,5QY ,K PLAS HOLDINGS LIMITED,31-Dec-07,44,-2,42
115,GTI2013,SG1B17008288,5QZ ,CCM GROUP LIMITED,31-Dec-12,47,1,48
292,GTI2012,SG1B17008288,5QZ ,CCM GROUP LTD,31-Dec-10,34,0,34
302,GTI2013,SG1B17008288,5RA ,ASIA-PACIFIC STRATEGIC INV LTD,30-Jun-12,36,0,36
242,GTI2012,SG1B17008288,5RA ,ASIA-PACIFIC STRATEGIC INVESTMENTS LTD,30-Jun-11,36,0,36
186,GTI2011,SG1B17008288,5RA ,ASIA-PACIFIC STRATEGIC INV LTD,30-Jun-10,36,0,36
235,GTI2010,SG1B21008464,5RA ,ASIA-PACIFIC STRATEGIC INV LTD,30-Jun-09,36,0,36
353,GTI2013,SG1B21008464,5RC ,ES GROUP (HOLDINGS) LIMITED,31-Dec-12,41,-7,34
242,GTI2012,SG1B21008464,5RC ,ES GROUP (HLDGS) LTD,31-Dec-10,38,-2,36
396,GTI2013,SG1B21008464,5RE ,SMARTFLEX HOLDINGS LTD,31-Dec-12,34,-2,32
500,GTI2012,SG1B21008464,5RE ,SMARTFLEX HLDGS LTD,31-Dec-10,26,0,26
302,GTI2013,SG1B37000984,5RF ,CCFH LTD,31-Dec-12,46,-10,36
436,GTI2012,SG1B37000984,5RF ,FRIVEN & CO LTD,31-Dec-10,31,-2,29
588,GTI2011,SG1B37000984,5RF ,FRIVEN & CO. LTD.,31-Dec-09,24,-8,16
633,GTI2010,SG1B37000984,5RF ,FRIVEN & CO. LTD.,31-Mar-09,24,-6,18
292,GTI2009,SG1B37000984,5RF ,FRIVEN & CO. LTD.,31-Mar-08,32,3,35
185,GTI2013,SG1B49001004,5RJ ,WE HOLDINGS LTD.,31-Mar-12,46,-5,41
455,GTI2012,SG1B49001004,5RJ ,WE HLDGS LTD,31-Dec-10,38,-10,28
642,GTI2011,SG1B49001004,5RJ ,WESTECH ELECTRONICS LIMITED,31-Dec-09,33,-27,6
679,GTI2010,SG1B49001004,5RJ ,WESTECH ELECTRONICS LIMITED,31-Dec-08,28,-31,-3
558,GTI2009,SG1B49001004,5RJ ,WESTECH ELECTRONICS LIMITED,31-Dec-07,33,-8,25
132,GTI2013,SG1B51001017,5RK ,KREUZ HOLDINGS LIMITED,31-Dec-12,41,5,46
177,GTI2012,SG1B51001017,5RK ,KREUZ HLDGS LTD,31-Dec-10,35,4,39
207,GTI2013,SG1B51001017,5SO ,DUTY FREE INTERNATIONALLIMITED,29-Feb-12,39,1,40
379,GTI2012,SG1B51001017,5SO ,DUTY FREE INTERNATIONAL LTD,28-Feb-11,28,3,31
254,GTI2011,SG1B51001017,5SO ,ESMART HOLDINGS LIMITED,31-Dec-09,33,0,33
323,GTI2010,SG1B56010922,5SO ,ESMART HOLDINGS LIMITED,31-Dec-08,33,0,33
82,GTI2009,SG1B56010922,5SO ,ESMART HOLDINGS LIMITED,31-Dec-07,43,0,43
326,GTI2013,SG1B56010922,5SR ,ZHONGMIN BAIHUI RETAIL GRP LTD,31-Dec-12,34,1,35
154,GTI2013,SG1B56010922,5SY ,CHEW'S GROUP LIMITED,30-Sep-12,40,4,44
353,GTI2013,SG1B56010922,5TF ,JUNMA TYRE CORD COMPANY LTD,31-Dec-12,41,-7,34
379,GTI2012,SG1B73011663,5TF ,JUNMA TYRE CORD COMPANY LTD,31-Dec-10,31,0,31
210,GTI2011,SG1B73011663,5TF ,JUNMA TYRE CORD COMPANY LTD,31-Dec-09,34,1,35
352,GTI2010,SG1B73011663,5TF ,JUNMA TYRE CORD COMPANY LTD,31-Dec-08,34,-2,32
529,GTI2009,SG1B73011663,5TF ,JUNMA TYRE CORD COMPANY LTD,31-Dec-07,34,-8,26
273,GTI2013,SG1B73011663,5TG ,800 SUPER HOLDINGS LIMITED,30-Jun-12,34,3,37
455,GTI2012,SG1B93012089,5TG ,800 SUPER HLDGS LTD,30-Jun-11,25,3,28
207,GTI2013,SG1B93012089,5TH ,MALACCA TRUST LIMITED,31-Dec-12,40,0,40
373,GTI2013,SG1B93012089,5TI ,KITCHEN CULTURE HOLDINGS LTD.,31-Dec-12,32,1,33
273,GTI2013,SG1B93012089,5TJ ,FAR EAST GROUP LIMITED,31-Dec-12,36,1,37
302,GTI2013,SG1B93012089,5TN ,IEV HOLDINGS LIMITED,31-Dec-12,38,-2,36
154,GTI2013,SG1C01001033,5TP ,CNMC GOLDMINE HOLDINGS LIMITED,31-Dec-12,49,-5,44
162,GTI2013,SG1C01001033,5TR ,LIBRA GROUP LIMITED,31-Dec-12,45,-2,43
273,GTI2013,SG1C01001033,5TT ,KEONG HONG HOLDINGS LIMITED,30-Sep-12,42,-5,37
373,GTI2013,SG1C01001033,5TW ,CHASWOOD RESOURCES HOLDINGS LTD,31-Dec-12,35,-2,33
455,GTI2012,SG1C01001033,5TW ,ASIA SILK HLDGS LTD,31-Dec-10,30,-2,28
430,GTI2011,SG1C06012761,5TW ,ASIA SILK HOLDINGS LIMITED,31-Dec-09,28,-2,26
468,GTI2010,SG1C06012761,5TW ,ASIA SILK HOLDINGS LIMITED,31-Dec-08,31,-3,28
166,GTI2009,SG1C06012761,5TW ,ASIA SILK HOLDINGS LIMITED,31-Dec-07,41,-2,39
273,GTI2013,SG1C06012761,5TY ,ADVANCED SYSTEMS AUTOMATION,31-Dec-12,39,-2,37
355,GTI2012,SG1C06012761,5TY ,ADVANCED SYSTEMS AUTOMATION LTD,31-Dec-10,38,-6,32
210,GTI2011,SG1C10012922,5TY ,ADVANCED SYSTEMS AUTOMATION,31-Dec-09,37,-2,35
235,GTI2010,SG1C10012922,5TY ,ADVANCED SYSTEMS AUTOMATION,31-Dec-08,36,0,36
111,GTI2009,SG1C10012922,5TY ,ADVANCED SYSTEMS AUTOMATION,31-Dec-07,43,-2,41
373,GTI2013,SG1C10012922,5UE ,SHC CAPITAL ASIA LIMITED,31-Dec-12,33,0,33
355,GTI2012,SG1C10012922,5UE ,SHC CAPITAL LTD,31-Dec-10,37,-5,32
346,GTI2011,SG1C12012995,5UE ,SHC CAPITAL LIMITED,31-Dec-09,37,-8,29
395,GTI2010,SG1C12012995,5UE ,SHC CAPITAL LIMITED,31-Dec-08,31,0,31
228,GTI2009,SG1C12012995,5UE ,SHC CAPITAL LIMITED,31-Dec-07,37,0,37
588,GTI2013,SG1C12012995,5UL ,ATLANTIC NAVIGATION HOLDINGS LIMITED,31-Dec-12,30,-7,23
587,GTI2012,SG1C12012995,5UL ,FASTUBE LTD,31-Dec-10,27,-5,22
557,GTI2011,SG1C18013138,5UL ,FASTUBE LIMITED,31-Dec-09,23,-4,19
640,GTI2010,SG1C18013138,5UL ,FASTUBE LIMITED,31-Dec-08,21,-5,16
591,GTI2009,SG1C18013138,5UL ,FASTUBE LIMITED (FORMERLY LINK HI HOLDINGS LTD),31-Dec-07,28,-5,23
480,GTI2013,SG1C18013138,5UV ,P99 HOLDINGS LIMITED,31-Dec-12,29,0,29
622,GTI2012,SG1C18013138,5UV ,CHINA FASHION HLDGS LTD,31-Dec-10,24,-5,19
326,GTI2013,SG1C19013145,5UX ,OXLEY HOLDINGS LIMITED,30-Jun-12,37,-2,35
355,GTI2012,SG1C19013145,5UX ,OXLEY HLDGS LTD,30-Jun-11,29,3,32
108,GTI2013,SG1C19013145,5VT ,EUNETWORKS GROUP LIMITED,31-Dec-12,53,-4,49
566,GTI2013,SG1C19013145,A01 ,CHINA AUTO CORPORATION LTD.,31-Dec-12,33,-8,25
602,GTI2012,SG1C19013145,A01 ,CHINA AUTO CORP LTD,31-Dec-10,26,-5,21
544,GTI2011,SG1C20001063,A01 ,CHINA AUTO CORPORATION LTD.,31-Dec-09,27,-7,20
417,GTI2010,SG1C20001063,A01 ,CHINA AUTO CORPORATION LTD.,31-Dec-08,30,0,30
578,GTI2013,SG1C20001063,A02 ,ACHIEVA LIMITED,31-Dec-12,32,-8,24
633,GTI2012,SG1C20001063,A02 ,ACHIEVA LTD,31-Dec-10,33,-15,18
588,GTI2011,SG1C20001063,A02 ,ACHIEVA LIMITED,31-Dec-09,34,-18,16
679,GTI2010,SG1C67001091,A02 ,ACHIEVA LIMITED,31-Dec-08,18,-21,-3
675,GTI2009,SG1C67001091,A02 ,ACHIEVA LIMITED,31-Dec-07,18,-16,2
396,GTI2013,SG1C67001091,A03 ,ASIA POWER CORPORATION LTD,31-Dec-11,41,-9,32
242,GTI2012,SG1C67001091,A03 ,ASIA POWER CORP LTD,31-Dec-10,39,-3,36
458,GTI2011,SG1C67001091,A03 ,ASIA POWER CORP LTD,31-Dec-09,33,-8,25
352,GTI2010,SG1C75001109,A03 ,ASIA POWER CORP LTD,31-Dec-08,38,-6,32
529,GTI2009,SG1C75001109,A03 ,ASIA POWER CORP LTD,31-Dec-07,36,-10,26
8,GTI2013,SG1C75001109,A04 ,ASL MARINE HOLDINGS LTD,30-Jun-12,74,16,90
9,GTI2012,SG1C75001109,A04 ,ASL MARINE HLDGS LTD,30-Jun-11,68,15,83
12,GTI2011,SG1C75001109,A04 ,ASL MARINE HOLDINGS LTD,30-Jun-10,71,4,75
18,GTI2010,SG1C95016004,A04 ,ASL MARINE HOLDINGS LTD,30-Jun-09,68,-8,60
228,GTI2009,SG1C95016004,A04 ,ASL MARINE HOLDINGS LTD,30-Jun-08,45,-8,37
302,GTI2013,SG1C95016004,A0G ,CHINA ENERGY LIMITED,31-Dec-12,45,-9,36
196,GTI2012,SG1C95016004,A0G ,CHINA ENERGY LTD,31-Dec-10,46,-8,38
281,GTI2011,SG1C95016004,A0G ,CHINA ENERGY LIMITED,31-Dec-09,40,-8,32
323,GTI2010,SG1C99001119,A0G ,CHINA ENERGY LIMITED,31-Dec-08,42,-9,33
228,GTI2009,SG1C99001119,A0G ,CHINA ENERGY LIMITED,31-Dec-07,36,1,37
145,GTI2013,SG1C99001119,A10 ,AEM HOLDINGS LTD,31-Dec-12,46,-1,45
220,GTI2012,SG1C99001119,A10 ,AEM HLDGS LTD,31-Dec-10,39,-2,37
92,GTI2011,SG1C99001119,A10 ,AEM HOLDINGS LTD,31-Dec-09,44,-2,42
148,GTI2010,SG1D14016522,A10 ,AEM HOLDINGS LTD,31-Dec-08,43,-3,40
140,GTI2009,SG1D14016522,A10 ,AEM HOLDINGS LTD,30-Jun-08,46,-6,40
252,GTI2013,SG1D14016522,A13 ,ALLIED TECHNOLOGIES LIMITED,31-Dec-12,46,-8,38
317,GTI2012,SG1D14016522,A13 ,ALLIED TECHNOLOGIES LTD,31-Dec-10,39,-6,33
346,GTI2011,SG1D14016522,A13 ,ALLIED TECHNOLOGIES LIMITED,31-Dec-09,37,-8,29
586,GTI2010,SG1D25001158,A13 ,ALLIED TECHNOLOGIES LIMITED,31-Dec-08,34,-11,23
357,GTI2009,SG1D25001158,A13 ,ALLIED TECHNOLOGIES LIMITED,31-Dec-07,40,-7,33
207,GTI2013,SG1D25001158,A14,ARMSTRONG INDUSTRIAL CORPORATION LTD,31-Dec-12,45,-5,40
131,GTI2012,SG1D25001158,A14,ARMSTRONG INDUSTRIAL CORP LTD,31-Dec-10,47,-5,42
149,GTI2011,SG1D25001158,A14,ARMSTRONG INDUSTRIAL CORP LTD,31-Dec-09,46,-8,38
235,GTI2010,SG1D57018229,A14,ARMSTRONG INDUSTRIAL CORP LTD,31-Dec-08,42,-6,36
629,GTI2009,SG1D57018229,A14,ARMSTRONG INDUSTRIAL CORP LTD,31-Dec-07,23,-3,20
663,GTI2013,SG1D57018229,A15 ,AUSSINO GROUP LTD,30-Jun-12,22,-26,-4
622,GTI2012,SG1D57018229,A15 ,AUSSINO GROUP LTD,30-Jun-11,24,-5,19
638,GTI2011,SG1D57018229,A15 ,AUSSINO GROUP LTD,30-Jun-10,20,-12,8
652,GTI2010,SG1D58018368,A15 ,AUSSINO GROUP LTD,30-Jun-09,22,-8,14
558,GTI2009,SG1D58018368,A15 ,AUSSINO GROUP LTD,30-Jun-08,28,-3,25
373,GTI2013,SG1D58018368,A18 ,AEI CORPORATION LTD,31-Dec-12,38,-5,33
242,GTI2012,SG1D58018368,A18 ,AEI CORP LTD,31-Dec-10,36,0,36
186,GTI2011,SG1D58018368,A18 ,AEI CORPORATION LTD,31-Dec-09,38,-2,36
395,GTI2010,SG1D60018406,A18 ,AEI CORPORATION LTD,31-Dec-08,36,-5,31
357,GTI2009,SG1D60018406,A18 ,AEI CORPORATION LTD,31-Dec-07,41,-8,33
302,GTI2013,SG1D60018406,A23 ,AURIC PACIFIC GROUP LIMITED,31-Dec-12,36,0,36
220,GTI2012,SG1D60018406,A23 ,AURIC PACIFIC GROUP LTD,31-Dec-10,43,-6,37
92,GTI2011,SG1D60018406,A23 ,AURIC PACIFIC GROUP LIMITED,31-Dec-09,48,-6,42
43,GTI2010,SG1D61018413,A23 ,AURIC PACIFIC GROUP LIMITED,31-Dec-08,55,-6,49
40,GTI2009,SG1D61018413,A23 ,AURIC PACIFIC GROUP LIMITED,31-Dec-07,48,0,48
185,GTI2013,SG1D61018413,A26 ,SINARMAS LAND LIMITED,31-Dec-12,38,3,41
115,GTI2012,SG1D61018413,A26 ,SINARMAS LAND LTD,31-Dec-10,40,3,43
254,GTI2011,SG1D61018413,A26 ,AFP PROPERTIES LTD (FORMERLY ASIA FOOD & PROPERTIES LTD),31-Dec-09,33,0,33
352,GTI2010,SG1D87001195,A26 ,ASIA FOOD & PROPERTIES LTD,31-Dec-08,32,0,32
505,GTI2009,SG1D87001195,A26 ,ASIA FOOD & PROPERTIES LTD,31-Dec-07,32,-5,27
132,GTI2013,SG1D87001195,A27 ,MDR LIMITED,31-Dec-12,53,-7,46
317,GTI2012,SG1D87001195,A27 ,MDR LTD,31-Dec-10,48,-15,33
588,GTI2011,SG1D87001195,A27 ,MDR LIMITED,31-Dec-09,35,-19,16
235,GTI2010,SG1D88474599,A27 ,MDR LIMITED,31-Dec-08,50,-14,36
97,GTI2009,SG1D88474599,A27 ,MDR LIMITED,31-Dec-07,49,-7,42
566,GTI2013,SG1D88474599,A30 ,ASPIAL CORPORATION LIMITED,31-Dec-12,31,-6,25
565,GTI2012,SG1D88474599,A30 ,ASPIAL CORP LTD,31-Dec-10,29,-6,23
458,GTI2011,SG1D89001201,A30 ,ASPIAL CORPORATION LIMITED,31-Dec-09,28,-3,25
564,GTI2010,SG1D89001201,A30 ,ASPIAL CORPORATION LIMITED,31-Dec-08,27,-3,24
442,GTI2009,SG1D89001201,A30 ,ASPIAL CORPORATION LIMITED,31-Dec-07,30,0,30
544,GTI2013,SG1D89001201,A31 ,ADDVALUE TECHNOLOGIES LTD,31-Mar-12,33,-7,26
587,GTI2012,SG1D89001201,A31 ,ADDVALUE TECHNOLOGIES LTD,31-Mar-11,30,-8,22
611,GTI2011,SG1D93474618,A31 ,ADDVALUE TECHNOLOGIES LTD,31-Mar-10,30,-16,14
498,GTI2010,SG1D93474618,A31 ,ADDVALUE TECHNOLOGIES LTD,31-Mar-09,35,-8,27
505,GTI2009,SG1D93474618,A31 ,ADDVALUE TECHNOLOGIES LTD,31-Mar-08,29,-2,27
373,GTI2013,SG1D93474618,A33 ,BLUMONT GROUP LTD.,31-Dec-12,38,-5,33
533,GTI2012,SG1D93474618,A33 ,BLUMONT GROUP LTD,31-Dec-10,28,-3,25
430,GTI2011,SG1D96849865,A33 ,ADROIT INNOVATIONS LIMITED,31-Dec-09,28,-2,26
628,GTI2010,SG1D96849865,A33 ,ADROIT INNOVATIONS LIMITED,31-Dec-08,21,-2,19
615,GTI2009,SG1D96849865,A33 ,ADROIT INNOVATIONS LIMITED,31-Dec-07,23,-2,21
588,GTI2013,SG1D96849865,A34 ,AMARA HOLDINGS LTD,31-Dec-12,28,-5,23
633,GTI2012,SG1D97850250,A34 ,AMARA HLDGS LTD,31-Dec-10,23,-5,18
496,GTI2011,SG1D97850250,A34 ,AMARA HOLDINGS LTD,31-Dec-09,25,-2,23
608,GTI2010,SG1D97850250,A34 ,AMARA HOLDINGS LTD,31-Dec-08,21,0,21
485,GTI2009,SG1D97850250,A34 ,AMARA HOLDINGS LTD,30-Sep-08,28,0,28
122,GTI2013,SG1D97850250,A46,ASIA PACIFIC BREWERIES LTD,30-Sep-12,47,0,47
149,GTI2012,SG1E13001268,A46,ASIA PACIFIC BREWERIES LTD,30-Sep-11,44,-3,41
66,GTI2011,SG1E13001268,A46,ASIA PACIFIC BREWERIES LTD,30-Sep-10,52,-6,46
70,GTI2009,SG1E13001268,A46,ASIA PACIFIC BREWERIES LTD,30-Sep-07,46,-2,44
132,GTI2013,SG1E13001268,A50 ,ROWSLEY LTD.,31-Mar-12,49,-3,46
156,GTI2012,SG1E13001268,A50 ,ROWSLEY LTD,31-Mar-11,40,0,40
40,GTI2011,SG1E19001288,A50 ,ROWSLEY LTD.,31-Mar-10,52,0,52
25,GTI2010,SG1E19001288,A50 ,ROWSLEY LTD.,31-Mar-09,56,0,56
166,GTI2009,SG1E19001288,A50 ,ROWSLEY LTD.,31-Mar-08,44,-5,39
326,GTI2013,SG1E19001288,A52 ,ANNAIK LIMITED,31-Dec-12,39,-4,35
611,GTI2012,SG1E19001288,A52 ,ANNAIK LTD,31-Dec-10,31,-11,20
496,GTI2011,SG1E20001293,A52 ,ANNAIK LIMITED,31-Dec-09,33,-10,23
447,GTI2010,SG1E20001293,A52 ,ANNAIK LIMITED,31-Dec-08,34,-5,29
485,GTI2009,SG1E20001293,A52 ,ANNAIK LIMITED,31-Dec-07,31,-3,28
450,GTI2013,SG1E20001293,A53 ,A-SONIC AEROSPACE LIMITED,31-Dec-12,32,-2,30
317,GTI2012,SG1E20001293,A53 ,A-SONIC AEROSPACE LTD,31-Dec-10,33,0,33
346,GTI2011,SG1E21850698,A53 ,A-SONIC AEROSPACE LIMITED,31-Dec-09,31,-2,29
352,GTI2010,SG1E21850698,A53 ,A-SONIC AEROSPACE LIMITED,31-Dec-08,32,0,32
442,GTI2009,SG1E21850698,A53 ,A-SONIC AEROSPACE LIMITED,31-Dec-07,33,-3,30
480,GTI2013,SG1E21850698,A54 ,ADV INTEGRATED MFG CORP LTD,31-Dec-12,39,-10,29
317,GTI2012,SG1E32850828,A54 ,ADVANCED INTEGRATED MANUFACTURING CORP LTD,31-Dec-10,37,-4,33
430,GTI2011,SG1E32850828,A54 ,ADVANCED INTEGRATED MANUFACTURING CORP. LTD.,31-Dec-09,30,-4,26
586,GTI2010,SG1E32850828,A54 ,ADVANCED INTEGRATED MANUFACTURING CORP. LTD.,31-Dec-08,23,0,23
574,GTI2009,SG1E32850828,A54 ,ADV INTEGRATED MFG CORP LTD,31-Dec-07,24,0,24
122,GTI2013,SG1E32850828,A55 ,ASIA ENTERPRISES HOLDING LTD,31-Dec-12,49,-2,47
66,GTI2012,SG1E34851329,A55 ,ASIA ENTERPRISES HLDG LTD,31-Dec-10,46,4,50
62,GTI2011,SG1E34851329,A55 ,ASIA ENTERPRISES HOLDING LTD,31-Dec-09,48,-1,47
129,GTI2010,SG1E34851329,A55 ,ASIA ENTERPRISES HOLDING LTD,31-Dec-08,43,-2,41
140,GTI2009,SG1E34851329,A55 ,ASIA ENTERPRISES HOLDING LTD,31-Dec-07,45,-5,40
544,GTI2013,SG1E34851329,A59 ,ACTION ASIA LIMITED,31-Dec-12,27,-1,26
379,GTI2012,SG1E36851343,A59 ,ACTION ASIA LTD,31-Dec-10,30,1,31
407,GTI2011,SG1E36851343,A59 ,ACTION ASIA LIMITED,31-Dec-09,26,1,27
417,GTI2010,SG1E36851343,A59 ,ACTION ASIA LIMITED,31-Dec-08,30,0,30
505,GTI2009,SG1E36851343,A59 ,ACTION ASIA LIMITED,31-Dec-07,27,0,27
410,GTI2012,SG1E36851343,A61,LUYE PHARMA GROUP LTD,31-Dec-10,38,-8,30
377,GTI2011,SG1E42851378,A61,LUYE PHARMA GROUP LTD.,31-Dec-09,35,-7,28
395,GTI2010,SG1E42851378,A61,LUYE PHARMA GROUP LTD.,31-Dec-08,36,-5,31
228,GTI2009,SG1E42851378,A61,ASIAPHARM GROUP LTD,31-Dec-07,48,-11,37
353,GTI2013,SG1E42851378,A69 ,AZEUS SYSTEMS HOLDINGS LTD.,31-Mar-12,42,-8,34
177,GTI2012,SG1E42851378,A69 ,AZEUS SYSTEMS HLDGS LTD,31-Mar-11,47,-8,39
118,GTI2011,SG1E47852223,A69 ,AZEUS SYSTEMS HOLDINGS LTD.,31-Mar-10,44,-3,41
323,GTI2010,SG1E47852223,A69 ,AZEUS SYSTEMS HOLDINGS LTD.,31-Mar-09,36,-3,33
140,GTI2009,SG1E47852223,A69 ,AZEUS SYSTEMS HOLDINGS LTD.,31-Mar-08,40,0,40
252,GTI2013,SG1E47852223,A6F ,UNIONMET (SINGAPORE) LIMITED,30-Nov-12,35,3,38
177,GTI2012,SG1E47852223,A6F ,UNIONMET (S) LTD,30-Nov-10,39,0,39
254,GTI2011,SG1E49001316,A6F ,UNIONMET (SINGAPORE) LIMITED,30-Nov-09,35,-2,33
267,GTI2010,SG1E49001316,A6F ,UNIONMET (SINGAPORE) LIMITED,30-Nov-08,35,0,35
228,GTI2009,SG1E49001316,A6F ,UNIONMET (SINGAPORE) LIMITED,30-Nov-07,37,0,37
649,GTI2013,SG1E49001316,A75 ,ACE ACHIEVE INFOCOM LIMITED,30-Apr-12,24,-9,15
646,GTI2012,SG1E52852266,A75 ,ACE ACHIEVE INFOCOM LTD,30-Apr-11,21,-5,16
575,GTI2011,SG1E52852266,A75 ,ACE ACHIEVE INFOCOM LIMITED,30-Apr-10,22,-5,17
564,GTI2010,SG1E52852266,A75 ,ACE ACHIEVE INFOCOM LIMITED,30-Apr-09,27,-3,24
654,GTI2009,SG1E52852266,A75 ,ACE ACHIEVE INFOCOM LIMITED,31-Dec-07,23,-8,15
174,GTI2013,SG1E52852266,A78 ,LIONGOLD CORP LTD,31-Mar-12,44,-2,42
242,GTI2012,SG1E56852940,A78 ,LIONGOLD CORP LTD,31-Mar-11,36,0,36
92,GTI2011,SG1E56852940,A78 ,THE THINK ENVIRONMENTAL CO LTD (FORMERLY ASIA TIGER GROUP LTD),31-Mar-10,41,1,42
323,GTI2010,SG1E56852940,A78 ,THE THINK ENVIRONMENTAL CO LTD (Formerly Asia Tiger Group Ltd),31-Mar-09,35,-2,33
463,GTI2009,SG1E56852940,A78 ,ASIA TIGER GROUP LIMITED,31-Mar-08,31,-2,29
450,GTI2013,SG1E56852940,A7S ,SUNVIC CHEMICAL HOLDINGS LTD,31-Dec-12,35,-5,30
268,GTI2012,SG1E67853093,A7S ,SUNVIC CHEMICAL HLDGS LTD,31-Dec-10,38,-3,35
165,GTI2011,SG1E67853093,A7S ,SUNVIC CHEMICAL HOLDINGS LTD,31-Dec-09,39,-2,37
148,GTI2010,SG1E67853093,A7S ,SUNVIC CHEMICAL HOLDINGS LTD,31-Dec-08,40,0,40
166,GTI2009,SG1E67853093,A7S ,SUNVIC CHEMICAL HOLDINGS LTD,31-Dec-07,42,-3,39
177,GTI2012,SG1E67853093,A8J,CHINA FARM EQUIPMENT LTD,31-Dec-10,39,0,39
254,GTI2011,SG1E97853881,A8J,CHINA FARM EQUIPMENT LIMITED,31-Dec-09,40,-7,33
267,GTI2010,SG1E97853881,A8J,CHINA FARM EQUIPMENT LIMITED,31-Dec-08,37,-2,35
111,GTI2009,SG1E97853881,A8J,CHINA FARM EQUIPMENT LIMITED,31-Dec-07,46,-5,41
639,GTI2013,SG1E97853881,AD7 ,CHINA BEARING (SINGAPORE) LTD,31-Dec-12,25,-7,18
550,GTI2012,SG1E97853881,AD7 ,CHINA BEARING (S) LTD,31-Dec-10,23,1,24
479,GTI2011,SG1F08854688,AD7 ,CHINA BEARING (SINGAPORE) LTD.,31-Dec-09,26,-2,24
323,GTI2010,SG1F08854688,AD7 ,CHINA BEARING (SINGAPORE) LTD.,31-Dec-08,30,3,33
357,GTI2009,SG1F08854688,AD7 ,CHINA BEARING (SINGAPORE) LTD.,31-Dec-07,32,1,33
479,GTI2011,SG1F08854688,AD8 ,SINO TECHFIBRE LIMITED,31-Dec-09,44,-20,24
296,GTI2010,SG1F08854688,AD8 ,SINO TECHFIBRE LIMITED,31-Dec-08,34,0,34
111,GTI2009,SG1F10854866,AD8 ,SINO TECHFIBRE LIMITED,31-Dec-07,44,-3,41
450,GTI2013,SG1F10854866,AI1 ,TEXCHEM-PACK HOLDINGS (S) LTD.,31-Dec-11,35,-5,30
355,GTI2012,SG1F10854866,AI1 ,TEXCHEM-PACK HLDGS (S) LTD,31-Dec-10,29,3,32
479,GTI2011,SG1F10854866,AI1 ,TEXCHEM-PACK HOLDINGS (S) LTD.,31-Dec-09,26,-2,24
395,GTI2010,SG1F29855813,AI1 ,TEXCHEM-PACK HOLDINGS (S) LTD.,31-Dec-08,31,0,31
330,GTI2009,SG1F29855813,AI1 ,TEXCHEM-PACK HOLDINGS (S) LTD.,31-Dec-07,37,-3,34
34,GTI2012,SG1F29855813,AJ1,SAKARI RESOURCES LTD,31-Dec-10,58,6,64
92,GTI2011,SG1F29855813,AJ1,STRAITS ASIA RESOURCES LIMITED,31-Dec-09,49,-7,42
72,GTI2010,SG1F29855813,AJ1,STRAITS ASIA RESOURCES LIMITED,31-Dec-08,53,-8,45
40,GTI2009,SG1F31001349,AJ1,STRAITS ASIA RESOURCES LIMITED,31-Dec-07,56,-8,48
230,GTI2013,SG1F31001349,AJ2 ,OUHUA ENERGY HOLDINGS LIMITED,31-Dec-12,41,-2,39
92,GTI2012,SG1F31001349,AJ2 ,OUHUA ENERGY HLDGS LTD,31-Dec-10,45,0,45
230,GTI2011,SG1F31001349,AJ2 ,OUHUA ENERGY HOLDINGS LIMITED,31-Dec-09,39,-5,34
323,GTI2010,SG1F31001349,AJ2 ,OUHUA ENERGY HOLDINGS LIMITED,31-Dec-08,35,-2,33
166,GTI2009,SG1F41856716,AJ2 ,OUHUA ENERGY HOLDINGS LIMITED,31-Dec-07,44,-5,39
102,GTI2013,SG1F41856716,AK3 ,SWIBER HOLDINGS LIMITED,31-Dec-12,46,4,50
73,GTI2012,SG1F41856716,AK3 ,SWIBER HLDGS LTD,31-Dec-10,51,-2,49
92,GTI2011,SG1F41856716,AK3 ,SWIBER HOLDINGS LIMITED,31-Dec-09,43,-1,42
129,GTI2010,SG1F41856716,AK3 ,SWIBER HOLDINGS LIMITED,31-Dec-08,43,-2,41
111,GTI2009,SG1F42856756,AK3 ,SWIBER HOLDINGS LIMITED,31-Dec-07,43,-2,41
621,GTI2013,SG1F42856756,AM3 ,GEMS TV HOLDINGS LIMITED,30-Jun-12,24,-4,20
602,GTI2012,SG1F42856756,AM3 ,GEMS TV HLDGS LTD,30-Jun-11,23,-2,21
496,GTI2011,SG1F42856756,AM3 ,GEMS TV HOLDINGS LIMITED,30-Jun-10,27,-4,23
99,GTI2010,SG1F42856756,AM3 ,GEMS TV HOLDINGS LIMITED,30-Jun-09,43,0,43
97,GTI2009,SG1F48858053,AM3 ,GEMS TV HOLDINGS LIMITED,30-Jun-08,42,0,42
77,GTI2013,SG1F48858053,AP4 ,RIVERSTONE HOLDINGS LIMITED,31-Dec-12,47,6,53
105,GTI2012,SG1F48858053,AP4 ,RIVERSTONE HLDGS LTD,31-Dec-10,41,3,44
46,GTI2011,SG1F48858053,AP4 ,RIVERSTONE HOLDINGS LIMITED,31-Dec-09,49,1,50
174,GTI2010,SG1F48858053,AP4 ,RIVERSTONE HOLDINGS LIMITED,31-Dec-08,36,3,39
140,GTI2009,SG1F58858209,AP4 ,RIVERSTONE HOLDINGS LIMITED,31-Dec-07,39,1,40
630,GTI2013,SG1F58858209,AV5 ,CHEMOIL ENERGY LIMITED,31-Dec-12,42,-23,19
565,GTI2012,SG1F58858209,AV5 ,CHEMOIL ENERGY LTD,31-Dec-10,43,-20,23
301,GTI2011,SG1F58858209,AV5 ,CHEMOIL ENERGY LIMITED,31-Mar-10,42,-11,31
323,GTI2010,SG1F58858209,AV5 ,CHEMOIL ENERGY LIMITED,31-Mar-09,39,-6,33
196,GTI2009,SG1F60858221,AV5 ,CHEMOIL ENERGY LIMITED,31-Dec-07,42,-4,38
598,GTI2013,SG1F60858221,B03 ,BRC ASIA LIMITED,30-Sep-12,24,-2,22
455,GTI2012,SG1F60858221,B03 ,BRC ASIA LTD,30-Sep-11,27,1,28
544,GTI2011,SG1F60858221,B03 ,BRC ASIA LIMITED,30-Sep-10,30,-10,20
352,GTI2010,SG1F60858221,B03 ,BRC ASIA LIMITED,30-Sep-08,34,-2,32
266,GTI2009,SG1F66858902,B03 ,BRC ASIA LIMITED,31-Dec-07,38,-2,36
659,GTI2013,SG1F66858902,B07 ,NEXT-GEN SATELLITE COMM LTD,31-Mar-11,33,-26,7
662,GTI2012,SG1F66858902,B07 ,NEXT-GEN SATELLITE COMM LTD,31-Mar-11,30,-18,12
575,GTI2011,SG1F66858902,B07 ,NEXT-GENERATION SATELLITE COMMUNICATIONS LIMITED (FORMERLY BAN JOO & COMPANY LIMITED),31-Mar-10,35,-18,17
586,GTI2010,SG1F66858902,B07 ,BAN JOO & COMPANY LIMITED,30-Sep-08,23,0,23
574,GTI2009,SG1F67858919,B07 ,BAN JOO & COMPANY LIMITED,30-Sep-07,24,0,24
630,GTI2013,SG1F67858919,B08 ,BRITISH & MALAYAN TRUSTEES LTD,30-Jun-12,34,-15,19
602,GTI2012,SG1F67858919,B08 ,BRITISH AND MALAYAN TRUSTEES LTD,30-Jun-11,24,-3,21
430,GTI2011,SG1F67858919,B08 ,BRITISH & MALAYAN TRUSTEES LTD,30-Jun-10,32,-6,26
586,GTI2010,SG1F67858919,B08 ,BRITISH & MALAYAN TRUSTEES LTD,30-Jun-09,29,-6,23
574,GTI2009,SG1F76860344,B08 ,BRITISH & MALAYAN TRUSTEES LTD,30-Jun-08,30,-6,24
230,GTI2013,SG1F76860344,B0I ,FORELAND FABRICTECH HLDS LTD,31-Dec-12,41,-2,39
268,GTI2012,SG1F76860344,B0I ,FORELAND FABRICTECH HLDGS LTD,31-Dec-10,34,1,35
407,GTI2011,SG1F76860344,B0I ,FORELAND FABRICTECH HLDS LTD,31-Dec-09,28,-1,27
468,GTI2010,SG1F76860344,B0I ,FORELAND FABRICTECH HLDS LTD,31-Dec-08,25,3,28
407,GTI2009,SG1F79860358,B0I ,FORELAND FABRICTECH HLDS LTD,31-Dec-07,33,-2,31
326,GTI2013,SG1F79860358,B0Z ,CHINA FISHERY GROUP LIMITED,28-Sep-12,37,-2,35
317,GTI2012,SG1F79860358,B0Z ,CHINA FISHERY GROUP LTD,28-Sep-11,32,1,33
92,GTI2011,SG1F79860358,B0Z ,CHINA FISHERY GROUP LIMITED,28-Sep-10,44,-2,42
267,GTI2010,SG1F84861094,B0Z ,CHINA FISHERY GROUP LIMITED,31-Dec-08,37,-2,35
140,GTI2009,SG1F84861094,B0Z ,CHINA FISHERY GROUP LIMITED,31-Dec-07,42,-2,40
162,GTI2013,SG1F84861094,B10 ,BOARDROOM LIMITED,30-Jun-12,46,-3,43
355,GTI2012,SG1F84861094,B10 ,BOARDROOM LTD,30-Jun-11,43,-11,32
230,GTI2011,SG1F84861094,B10 ,BOARDROOM LIMITED,30-Jun-10,45,-11,34
216,GTI2010,SG1F87001375,B10 ,BOARDROOM LIMITED,30-Jun-09,43,-6,37
97,GTI2009,SG1F87001375,B10 ,BOARDROOM LIMITED,30-Jun-08,42,0,42
450,GTI2013,SG1F87001375,B16 ,GUOCOLEISURE LIMITED,30-Jun-12,39,-9,30
355,GTI2012,SG1F87001375,B16 ,GUOCOLEISURE LTD,30-Jun-11,38,-6,32
325,GTI2011,SG1F87001375,B16 ,GUOCOLEISURE LIMITED,30-Jun-10,33,-3,30
235,GTI2010,SG1F88861140,B16 ,GUOCOLEISURE LIMITED,30-Jun-09,39,-3,36
407,GTI2009,SG1F88861140,B16 ,GUOCOLEISURE LIMITED,30-Jun-08,36,-5,31
57,GTI2013,SG1F88861140,B1N ,DELONG HOLDINGS LIMITED,31-Dec-12,56,4,60
92,GTI2012,SG1F88861140,B1N ,DELONG HLDGS LTD,31-Dec-10,45,0,45
301,GTI2011,SG1F88861140,B1N ,DELONG HOLDINGS LIMITED,31-Dec-09,35,-4,31
129,GTI2010,SG1F90001388,B1N ,DELONG HOLDINGS LIMITED,31-Dec-08,41,0,41
166,GTI2009,SG1F90001388,B1N ,DELONG HOLDINGS LIMITED,31-Dec-07,44,-5,39
317,GTI2012,SG1F90001388,B1ZU,RICKMERS MARITIME,31-Dec-10,38,-5,33
71,GTI2013,SG1F90001388,B20 ,"BIOSENSORS INTERNATIONAL GROUP, LTD.",31-Mar-12,52,3,55
268,GTI2012,SG1F90001388,B20 ,"BIOSENSORS INTERNATIONALGROUP, LTD",31-Mar-11,44,-9,35
301,GTI2011,SG1G23864448,B20 ,"BIOSENSORS INT'L GROUP, LTD.",31-Mar-10,40,-9,31
417,GTI2010,SG1G23864448,B20 ,"BIOSENSORS INT'L GROUP, LTD.",31-Mar-09,36,-6,30
330,GTI2009,SG1G23864448,B20 ,"BIOSENSORS INT'L GROUP, LTD.",31-Mar-08,37,-3,34
503,GTI2013,SG1G23864448,B22 ,HANKORE ENVIRONMENT TEC GRPLTD,30-Jun-12,33,-5,28
587,GTI2012,SG1G23864448,B22 ,HANKORE ENVIRONMENT TECH GROUP LTD,30-Jun-11,43,-21,22
646,GTI2011,SG1G27865383,B22 ,BIO-TREAT TECHNOLOGY LIMITED,30-Jun-10,37,-32,5
543,GTI2010,SG1G27865383,B22 ,BIO-TREAT TECHNOLOGY LIMITED,30-Jun-09,40,-15,25
634,GTI2009,SG1G27865383,B22 ,BIO-TREAT TECHNOLOGY LIMITED,30-Jun-08,34,-15,19
480,GTI2013,SG1G27865383,B26 ,BAN LEONG TECHNOLOGIES LIMITED,31-Mar-12,28,1,29
550,GTI2012,SG1G27865383,B26 ,BAN LEONG TECHNOLOGIES LTD,31-Mar-11,26,-2,24
377,GTI2011,SG1G32866137,B26 ,BAN LEONG TECHNOLOGIES LIMITED,31-Mar-10,27,1,28
296,GTI2010,SG1G32866137,B26 ,BAN LEONG TECHNOLOGIES LIMITED,31-Mar-09,31,3,34
292,GTI2009,SG1G32866137,B26 ,BAN LEONG TECHNOLOGIES LIMITED,31-Dec-07,35,0,35
480,GTI2013,SG1G32866137,B28 ,BONVESTS HOLDINGS LTD,31-Dec-12,37,-8,29
317,GTI2012,SG1G32866137,B28 ,BONVESTS HLDGS LTD,30-Dec-10,39,-6,33
377,GTI2011,SG1G33866144,B28 ,BONVESTS HOLDINGS LTD,31-Dec-09,39,-11,28
524,GTI2010,SG1G33866144,B28 ,BONVESTS HOLDINGS LTD,31-Dec-08,40,-14,26
383,GTI2009,SG1G33866144,B28 ,BONVESTS HOLDINGS LTD,31-Dec-07,43,-11,32
41,GTI2013,SG1G33866144,B2F ,M1 LIMITED,31-Dec-12,68,-3,65
17,GTI2012,SG1G33866144,B2F ,M1 LTD,31-Dec-10,74,2,76
46,GTI2011,SG1G40868794,B2F ,M1 LTD (FORMERLY MOBILEONE LTD),31-Dec-09,68,-18,50
42,GTI2010,SG1G40868794,B2F ,MOBILEONE LTD,31-Dec-08,62,-12,50
26,GTI2009,SG1G40868794,B2F ,MOBILEONE LTD,31-Dec-07,69,-17,52
36,GTI2012,SG1G40868794,B2W ,TOTAL ACCESS COMMUNICATION PUBLIC COMPANY LTD,31-Dec-10,53,9,62
24,GTI2011,SG1G40868794,B2W ,TOTAL ACCESS COMM PUB CO LTD,31-Dec-09,56,6,62
148,GTI2010,SG1G47869290,B2W ,TOTAL ACCESS COMM PUB CO LTD,31-Dec-08,37,3,40
53,GTI2009,SG1G47869290,B2W ,TOTAL ACCESS COMM PUB CO LTD,31-Dec-07,48,-2,46
503,GTI2013,SG1G47869290,B2X ,CHINA YUANBANG PROP HLDGS LTD,30-Jun-12,33,-5,28
317,GTI2012,SG1G47869290,B2X ,CHINA YUANBANG PROPERTY HLDGS LTD,30-Jun-11,36,-3,33
186,GTI2011,SG1G47869290,B2X ,CHINA YUANBANG PROP HLDGS LTD,30-Jun-10,38,-2,36
196,GTI2010,SG1G50869484,B2X ,CHINA YUANBANG PROP HLDGS LTD,30-Jun-09,38,0,38
330,GTI2009,SG1G50869484,B2X ,CHINA YUANBANG PROP HLDGS LTD,30-Jun-08,36,-2,34
122,GTI2013,SG1G50869484,B32 ,BH GLOBAL MARINE LIMITED,31-Dec-12,46,1,47
61,GTI2012,SG1G50869484,B32 ,BH GLOBAL MARINE LTD,31-Dec-10,50,1,51
76,GTI2011,SG1G50869484,B32 ,BH GLOBAL MARINE LIMITED,31-Dec-09,46,-2,44
30,GTI2010,SG1G55870362,B32 ,BH GLOBAL MARINE LIMITED,31-Dec-08,51,3,54
15,GTI2009,SG1G55870362,B32 ,BH GLOBAL MARINE LIMITED,31-Dec-07,55,0,55
162,GTI2013,SG1G55870362,B3C ,CHINA PRINT POWER GROUP LTD,31-Dec-12,42,1,43
292,GTI2012,SG1G55870362,B3C ,CHINA PRINT POWER GROUP LTD,31-Dec-10,36,-2,34
301,GTI2011,SG1G55870362,B3C ,CHINA PRINT POWER GROUP LTD,31-Dec-09,35,-4,31
498,GTI2010,SG1G56870536,B3C ,CHINA PRINT POWER GROUP LTD,31-Dec-08,32,-5,27
407,GTI2009,SG1G56870536,B3C ,CHINA PRINT POWER GROUP LTD,31-Dec-07,36,-5,31
650,GTI2009,SG1G56870536,B3C ,CHINA PRINTG & DYEING HLDG LTD,31-Dec-07,32,-15,17
185,GTI2013,SG1G56870536,B49 ,WORLD PRECISION MACHINERY LTD,31-Dec-12,44,-3,41
410,GTI2012,SG1G56870536,B49 ,WORLD PRECISION MACHINERY LTD,31-Dec-10,30,0,30
618,GTI2011,SG1G57870584,B49 ,BRIGHT WORLD PRECISION MAC LTD,31-Dec-09,32,-19,13
296,GTI2010,SG1G57870584,B49 ,BRIGHT WORLD PRECISION MAC LTD,31-Dec-08,34,0,34
266,GTI2009,SG1G57870584,B49 ,BRIGHT WORLD PRECISION MAC LTD,31-Dec-07,38,-2,36
36,GTI2013,SG1G57870584,B58 ,BANYAN TREE HOLDINGS LIMITED,31-Dec-12,65,3,68
30,GTI2012,SG1G57870584,B58 ,BANYAN TREE HLDGS LTD,31-Dec-10,69,-3,66
26,GTI2011,SG1G60871280,B58 ,BANYAN TREE HOLDINGS LIMITED,31-Dec-09,59,0,59
57,GTI2010,SG1G60871280,B58 ,BANYAN TREE HOLDINGS LIMITED,31-Dec-08,52,-5,47
46,GTI2009,SG1G60871280,B58 ,BANYAN TREE HOLDINGS LIMITED,31-Dec-07,49,-2,47
67,GTI2013,SG1G60871280,B61 ,BUKIT SEMBAWANG ESTATES LTD,31-Mar-12,53,3,56
43,GTI2012,SG1G60871280,B61 ,BUKIT SEMBAWANG ESTATES LTD,31-Mar-11,49,6,55
129,GTI2011,SG1G69871497,B61 ,BUKIT SEMBAWANG ESTATES LTD,31-Mar-10,45,-5,40
72,GTI2010,SG1G69871497,B61 ,BUKIT SEMBAWANG ESTATES LTD,31-Mar-09,45,0,45
166,GTI2009,SG1G69871497,B61 ,BUKIT SEMBAWANG ESTATES LTD,31-Mar-08,42,-3,39
353,GTI2013,SG1G69871497,B64 ,BERGER INTERNATIONAL LIMITED,31-Mar-12,39,-5,34
149,GTI2012,SG1G69871497,B64 ,BERGER INTERNATIONAL LTD,31-Mar-11,46,-5,41
92,GTI2011,SG1G71871634,B64 ,BERGER INTERNATIONAL LIMITED,31-Mar-10,44,-2,42
196,GTI2010,SG1G71871634,B64 ,BERGER INTERNATIONAL LIMITED,31-Dec-08,38,0,38
228,GTI2009,SG1G71871634,B64 ,BERGER INTERNATIONAL LIMITED,31-Dec-07,40,-3,37
485,GTI2009,SG1G71871634,B66 ,PT BERLIAN LAJU TANKER TBK,31-Dec-07,30,-2,28
480,GTI2013,SG1G71871634,B69 ,BROADWAY INDUSTRIAL GROUP LTD,31-Dec-12,34,-5,29
602,GTI2012,SG1G74871706,B69 ,BROADWAY INDUSTRIAL GROUP LTD,31-Dec-10,26,-5,21
588,GTI2011,SG1G74871706,B69 ,BROADWAY INDUSTRIAL GROUP LTD,31-Dec-09,26,-10,16
640,GTI2010,SG1G74871706,B69 ,BROADWAY INDUSTRIAL GROUP LTD,31-Dec-08,27,-11,16
505,GTI2009,SG1G74871706,B69 ,BROADWAY INDUSTRIAL GROUP LTD,31-Dec-07,32,-5,27
25,GTI2013,SG1G74871706,B73 ,GLOBAL INVESTMENTS LIMITED,31-Dec-12,68,10,78
82,GTI2012,SG1G77872271,B73 ,GLOBAL INVESTMENTS LTD,31-Dec-10,52,-5,47
230,GTI2011,SG1G77872271,B73 ,GLOBAL INVESTMENTS LIMITED (Formerly Babcock & Brown Global Investments Ltd),31-Dec-09,48,-14,34
64,GTI2010,SG1G77872271,B73 ,GLOBAL INVESTMENTS LIMITED (Formerly Babcock & Brown Global Investments Ltd),31-Dec-08,46,0,46
302,GTI2013,SG1G77872271,B7K ,SIN GHEE HUAT CORPORATION LTD.,30-Jun-12,41,-5,36
177,GTI2012,SG1G77872271,B7K ,SIN GHEE HUAT CORP LTD,30-Jun-11,41,-2,39
377,GTI2011,SG1G86872619,B7K ,SIN GHEE HUAT CORPORATION LTD.,30-Jun-10,38,-10,28
216,GTI2010,SG1G86872619,B7K ,SIN GHEE HUAT CORPORATION LTD.,30-Jun-09,43,-6,37
330,GTI2009,SG1G86872619,B7K ,SIN GHEE HUAT CORPORATION LTD.,30-Jun-08,40,-6,34
252,GTI2013,SG1G86872619,B9R ,CHINA XLX FERTILISER LTD,31-Dec-12,36,2,38
149,GTI2012,SG1G86872619,B9R ,CHINA XLX FERTILISER LTD,31-Dec-10,43,-2,41
149,GTI2011,SG1G89872947,B9R ,CHINA XLX FERTILISER LTD.,31-Dec-09,34,4,38
48,GTI2010,SG1G89872947,B9R ,CHINA XLX FERTILISER LTD.,31-Dec-08,45,3,48
82,GTI2009,SG1G89872947,B9R ,CHINA XLX FERTILISER LTD.,31-Dec-07,40,3,43
71,GTI2013,SG1G89872947,B9S ,COSMOSTEEL HOLDINGS LIMITED,30-Sep-12,56,-1,55
55,GTI2012,SG1G89872947,B9S ,COSMOSTEEL HLDGS LTD,30-Sep-10,46,6,52
129,GTI2011,SG1G91873040,B9S ,COSMOSTEEL HOLDINGS LIMITED,30-Sep-10,41,-1,40
115,GTI2010,SG1G91873040,B9S ,COSMOSTEEL HOLDINGS LIMITED,30-Sep-08,41,1,42
196,GTI2009,SG1G91873040,B9S ,COSMOSTEEL HOLDINGS LIMITED,30-Sep-07,40,-2,38
154,GTI2013,SG1G91873040,BN2 ,VALUETRONICS HOLDINGS LIMITED,31-Mar-12,49,-5,44
131,GTI2012,SG1G91873040,BN2 ,VALUETRONICS HLDGS LTD,31-Mar-11,42,0,42
140,GTI2011,SG1G93873220,BN2 ,VALUETRONICS HOLDINGS LIMITED,31-Mar-10,47,-8,39
267,GTI2010,SG1G93873220,BN2 ,VALUETRONICS HOLDINGS LIMITED,31-Mar-09,43,-8,35
266,GTI2009,SG1G93873220,BN2 ,VALUETRONICS HOLDINGS LIMITED,31-Mar-08,44,-8,36
3,GTI2013,SG1G93873220,BN4 ,KEPPEL CORPORATION LIMITED,31-Dec-12,87,20,107
4,GTI2012,SG1G93873220,BN4 ,KEPPEL CORP LTD,31-Dec-10,76,17,93
3,GTI2011,SG1G98873449,BN4 ,KEPPEL CORPORATION LIMITED,31-Dec-09,74,17,91
4,GTI2010,SG1G98873449,BN4 ,KEPPEL CORPORATION LIMITED,31-Dec-08,73,15,88
5,GTI2009,SG1G98873449,BN4 ,KEPPEL CORPORATION LIMITED,31-Dec-07,64,9,73
514,GTI2011,SG1G98873449,BR9 ,CHINA HONGXING SPORTS LIMITED,31-Dec-09,40,-18,22
129,GTI2010,SG1G98873449,BR9 ,CHINA HONGXING SPORTS LIMITED,31-Dec-08,49,-8,41
166,GTI2009,SG1H00001443,BR9 ,CHINA HONGXING SPORTS LIMITED,31-Dec-07,47,-8,39
353,GTI2013,SG1H00001443,BS6 ,YANGZIJIANG SHIPBLDG HLDGS LTD,31-Dec-12,36,-2,34
550,GTI2012,SG1H00001443,BS6 ,YANGZIJIANG SHIPBUILDING (HLDGS) LTD,31-Dec-10,27,-3,24
325,GTI2011,SG1H00001443,BS6 ,YANGZIJIANG SHIPBLDG HLDGS LTD,31-Dec-09,32,-2,30
296,GTI2010,SG1H00001443,BS6 ,YANGZIJIANG SHIPBLDG HLDGS LTD,31-Dec-08,39,-5,34
529,GTI2009,SG1H05873721,BS6 ,YANGZIJIANG SHIPBLDG HLDGS LTD,31-Dec-07,31,-5,26
525,GTI2013,SG1H05873721,C02,COMPACT METAL INDUSTRIES LTD,31-Dec-12,29,-2,27
483,GTI2012,SG1H05873721,C02,COMPACT METAL INDUSTRIES LTD,31-Dec-10,27,0,27
479,GTI2011,SG1H05873721,C02,COMPACT METAL INDUSTRIES LTD,31-Dec-09,26,-2,24
586,GTI2010,SG1H06873795,C02,COMPACT METAL INDUSTRIES LTD,31-Dec-08,26,-3,23
463,GTI2009,SG1H06873795,C02,COMPACT METAL INDUSTRIES LTD,31-Dec-07,29,0,29
630,GTI2013,SG1H06873795,C04 ,CASA HOLDINGS LIMITED,30-Sep-12,23,-4,19
533,GTI2012,SG1H06873795,C04 ,CASA HLDGS LTD,30-Sep-11,21,4,25
624,GTI2011,SG1H06873795,C04 ,CASA HOLDINGS LIMITED,30-Sep-10,20,-8,12
564,GTI2010,SG1H15874503,C04 ,CASA HOLDINGS LIMITED,30-Sep-08,21,3,24
529,GTI2009,SG1H15874503,C04 ,CASA HOLDINGS LIMITED,30-Sep-07,25,1,26
598,GTI2013,SG1H15874503,C05 ,CHEMICAL INDUSTRIES (F.E.) LTD,31-Mar-12,25,-3,22
565,GTI2012,SG1H15874503,C05 ,CHEMICAL INDUSTRIES (FAR EAST) LTD,31-Mar-11,26,-3,23
611,GTI2011,SG1H15874503,C05 ,CHEMICAL INDUSTRIES (F.E.) LTD,31-Mar-10,22,-8,14
599,GTI2010,SG1H18874567,C05 ,CHEMICAL INDUSTRIES (F.E.) LTD,31-Mar-09,22,0,22
505,GTI2009,SG1H18874567,C05 ,CHEMICAL INDUSTRIES (F.E.) LTD,31-Mar-08,27,0,27
373,GTI2013,SG1H18874567,C06 ,CSC HOLDINGS LTD,31-Mar-12,36,-3,33
436,GTI2012,SG1H18874567,C06 ,CSC HLDGS LTD,31-Mar-11,35,-6,29
407,GTI2011,SG1H18874567,C06 ,CSC HOLDINGS LTD,31-Mar-10,33,-6,27
323,GTI2010,SG1H26001476,C06 ,CSC HOLDINGS LTD,31-Mar-09,41,-8,33
383,GTI2009,SG1H26001476,C06 ,CSC HOLDINGS LTD,31-Mar-08,35,-3,32
145,GTI2013,SG1H26001476,C07 ,JARDINE CYCLE & CARRIAGE LTD,31-Dec-12,48,-3,45
115,GTI2012,SG1H26001476,C07 ,JARDINE CYCLE & CARRIAGE LTD,31-Dec-10,46,-3,43
92,GTI2011,SG1H26001476,C07 ,JARDINE CYCLE & CARRIAGE LTD,31-Dec-09,45,-3,42
148,GTI2010,SG1H27874756,C07 ,JARDINE CYCLE & CARRIAGE LTD,31-Dec-08,40,0,40
292,GTI2009,SG1H27874756,C07 ,JARDINE CYCLE & CARRIAGE LTD,31-Dec-07,37,-2,35
31,GTI2013,SG1H27874756,C09 ,CITY DEVELOPMENTS LIMITED,31-Dec-12,67,6,73
46,GTI2012,SG1H27874756,C09 ,CITY DEVELOPMENTS LTD,31-Dec-10,60,-6,54
66,GTI2011,SG1H27874756,C09 ,CITY DEVELOPMENTS LIMITED,31-Dec-09,58,-12,46
174,GTI2010,SG1H29874838,C09 ,CITY DEVELOPMENTS LIMITED,31-Dec-08,48,-9,39
61,GTI2009,SG1H29874838,C09 ,CITY DEVELOPMENTS LIMITED,31-Dec-07,48,-3,45
544,GTI2013,SG1H29874838,C0Z ,CHINA HONGCHENG HOLDINGS LTD,30-Jun-12,32,-6,26
317,GTI2012,SG1H29874838,C0Z ,CHINA HONGCHENG HLDGS LTD,30-Jun-11,30,3,33
281,GTI2011,SG1H29874838,C0Z ,CHINA HONGCHENG HOLDINGS LTD,30-Jun-10,32,0,32
395,GTI2010,SG1H33875235,C0Z ,CHINA HONGCHENG HOLDINGS LTD,30-Jun-09,34,-3,31
330,GTI2009,SG1H33875235,C0Z ,CHINA HONGCHENG HOLDINGS LTD,30-Jun-08,37,-3,34
62,GTI2013,SG1H33875235,C10 ,CHOSEN HOLDINGS LIMITED,30-Jun-12,54,4,58
55,GTI2012,SG1H33875235,C10 ,CHOSEN HLDGS LTD,30-Jun-11,55,-3,52
129,GTI2011,SG1H33875235,C10 ,CHOSEN HOLDINGS LIMITED,30-Jun-10,54,-14,40
82,GTI2010,SG1H36875612,C10 ,CHOSEN HOLDINGS LIMITED,30-Jun-09,50,-6,44
228,GTI2009,SG1H36875612,C10 ,CHOSEN HOLDINGS LIMITED,30-Jun-08,51,-14,37
185,GTI2013,SG1H36875612,C11 ,CEI CONTRACT MANUFACTURING LTD,31-Dec-12,44,-3,41
156,GTI2012,SG1H36875612,C11 ,CEI CONTRACT MANUFACTURING LTD,31-Dec-10,43,-3,40
92,GTI2011,SG1H36875612,C11 ,CEI CONTRACT MANUFACTURING LTD,31-Dec-09,47,-5,42
115,GTI2010,SG1H41875896,C11 ,CEI CONTRACT MANUFACTURING LTD,31-Dec-08,42,0,42
228,GTI2009,SG1H41875896,C11 ,CEI CONTRACT MANUFACTURING LTD,31-Dec-07,40,-3,37
273,GTI2013,SG1H41875896,C13 ,CH OFFSHORE LTD,30-Jun-12,37,0,37
379,GTI2012,SG1H41875896,C13 ,CH OFFSHORE LTD,30-Jun-11,34,-3,31
254,GTI2011,SG1H41875896,C13 ,CH OFFSHORE LTD,30-Jun-10,33,0,33
174,GTI2010,SG1H43875910,C13 ,CH OFFSHORE LTD,30-Jun-09,39,0,39
40,GTI2009,SG1H43875910,C13 ,CH OFFSHORE LTD,30-Jun-08,48,0,48
273,GTI2013,SG1H43875910,C14 ,CWT LIMITED,31-Dec-12,37,0,37
220,GTI2012,SG1H43875910,C14 ,CWT LTD,31-Dec-10,34,3,37
76,GTI2011,SG1H43875910,C14 ,CWT LIMITED,31-Dec-09,38,6,44
82,GTI2010,SG1H44875935,C14 ,CWT LIMITED,31-Dec-08,44,0,44
46,GTI2009,SG1H44875935,C14 ,CWT LIMITED,31-Dec-07,47,0,47
115,GTI2012,SG1H44875935,C20,CEREBOS PACIFIC LTD,31-Dec-10,49,-6,43
85,GTI2011,SG1H44875935,C20,CEREBOS PACIFIC LIMITED,30-Sep-09,48,-5,43
148,GTI2010,SG1H44875935,C20,CEREBOS PACIFIC LIMITED,30-Sep-08,46,-6,40
26,GTI2009,SG1H45875967,C20,CEREBOS PACIFIC LIMITED,30-Sep-07,49,3,52
396,GTI2013,SG1H45875967,C22 ,CHINA MERCHANTS HLDGS(PACIFIC),31-Dec-12,29,3,32
220,GTI2012,SG1H45875967,C22 ,CHINA MERCHANTS HLDGS (PACIFIC) LTD,31-Dec-10,37,0,37
301,GTI2011,SG1H45875967,C22 ,CHINA MERCHANTS HLDGS(PACIFIC),31-Dec-09,31,0,31
417,GTI2010,SG1H45875967,C22 ,CHINA MERCHANTS HLDGS(PACIFIC),31-Dec-08,30,0,30
266,GTI2009,SG1H85877246,C22 ,CHINA MERCHANTS HLDGS(PACIFIC),31-Dec-07,41,-5,36
598,GTI2013,SG1H85877246,C29 ,CHIP ENG SENG CORPORATION LTD,31-Dec-12,32,-10,22
500,GTI2012,SG1H85877246,C29 ,CHIP ENG SENG CORP LTD,31-Dec-10,35,-9,26
254,GTI2011,SG1H85877246,C29 ,CHIP ENG SENG CORPORATION LTD,31-Dec-09,46,-13,33
498,GTI2010,SG1H85877246,C29 ,CHIP ENG SENG CORPORATION LTD,31-Dec-08,38,-11,27
558,GTI2009,SG1H97877952,C29 ,CHIP ENG SENG CORPORATION LTD,31-Dec-07,36,-11,25
621,GTI2013,SG1H97877952,C2J ,SUNMART HOLDINGS LIMITED,31-Dec-11,32,-12,20
611,GTI2012,SG1H97877952,C2J ,SUNMART HLDGS LTD,31-Dec-10,33,-13,20
479,GTI2011,SG1H97877952,C2J ,SUNMART HOLDINGS LIMITED,31-Dec-09,37,-13,24
586,GTI2010,SG1H97877952,C2J ,SUNMART HOLDINGS LIMITED,31-Dec-08,33,-10,23
634,GTI2009,SG1I02877971,C2J ,SUNMART HOLDINGS LIMITED,31-Dec-07,21,-2,19
6,GTI2013,SG1I02877971,C31 ,CAPITALAND LIMITED,31-Dec-12,79,24,103
30,GTI2012,SG1I02877971,C31 ,CAPITALAND LTD,31-Dec-10,71,-5,66
24,GTI2011,SG1I02877971,C31 ,CAPITALAND LIMITED,31-Dec-09,67,-5,62
11,GTI2010,SG1I02877971,C31 ,CAPITALAND LIMITED,31-Dec-08,67,6,73
15,GTI2009,SG1I03877988,C31 ,CAPITALAND LIMITED,31-Dec-07,58,-3,55
207,GTI2013,SG1I03877988,C33 ,CHUAN HUP HOLDINGS LIMITED,30-Jun-12,40,0,40
196,GTI2012,SG1I03877988,C33 ,CHUAN HUP HLDGS LTD,30-Jun-11,44,-6,38
210,GTI2011,SG1I03877988,C33 ,CHUAN HUP HOLDINGS LIMITED,30-Jun-10,40,-5,35
72,GTI2010,SG1I04877995,C33 ,CHUAN HUP HOLDINGS LIMITED,30-Jun-09,47,-2,45
407,GTI2009,SG1I04877995,C33 ,CHUAN HUP HOLDINGS LIMITED,30-Jun-08,33,-2,31
587,GTI2012,SG1I06878272,C35,CREATIVE MASTER BERMUDA LTD,31-Dec-10,30,-8,22
407,GTI2011,SG1I06878272,C35,CREATIVE MASTER BERMUDA LTD,31-Dec-09,34,-7,27
417,GTI2010,SG1I06878272,C35,CREATIVE MASTER BERMUDA LTD,31-Dec-08,33,-3,30
140,GTI2009,SG1I06878272,C35,CREATIVE MASTER BERMUDA LTD,31-Dec-07,37,3,40
353,GTI2013,SG1I06878272,C37 ,CHINA INTERNATIONAL HLDGS LTD,31-Dec-12,36,-2,34
533,GTI2012,SG1I07878305,C37 ,CHINA INTERNATIONAL HLDGS LTD,31-Dec-10,31,-6,25
377,GTI2011,SG1I07878305,C37 ,CHINA INTERNATIONAL HLDGS LTD (FORMERLY CHINA INFRASTRUCTURE HLDGS LTD),31-Dec-09,33,-5,28
447,GTI2010,SG1I07878305,C37 ,CHINA INTERNATIONAL HLDGS LTD (FORMERLY CHINA INFRASTRUCTURE HLDGS LTD),31-Dec-08,37,-8,29
574,GTI2009,SG1I07878305,C37 ,CHINA INFRASTRUCTURE HLDGS LTD,31-Dec-07,30,-6,24
273,GTI2013,SG1I07878305,C3T,UNI-ASIA FINANCE CORPORATION,31-Dec-12,42,-5,37
292,GTI2012,SG1I10878425,C3T,UNI-ASIA FINANCE CORP,31-Dec-10,34,0,34
301,GTI2011,SG1I10878425,C3T,UNI-ASIA FINANCE CORPORATION,31-Dec-09,38,-7,31
174,GTI2010,SG1I10878425,C3T,UNI-ASIA FINANCE CORPORATION,31-Dec-08,38,1,39
383,GTI2009,SG1I10878425,C3T,UNI-ASIA FINANCE CORPORATION,31-Dec-07,35,-3,32
450,GTI2013,SG1I10878425,C41 ,CORTINA HOLDINGS LIMITED,31-Mar-12,32,-2,30
268,GTI2012,SG1I11878499,C41 ,CORTINA HLDGS LTD,31-Mar-11,32,3,35
458,GTI2011,SG1I11878499,C41 ,CORTINA HOLDINGS LIMITED,31-Mar-10,27,-2,25
543,GTI2010,SG1I11878499,C41 ,CORTINA HOLDINGS LIMITED,31-Mar-09,34,-9,25
634,GTI2009,SG1I11878499,C41 ,CORTINA HOLDINGS LIMITED,31-Mar-08,27,-8,19
525,GTI2013,SG1I11878499,C4P ,LH GROUP LIMITED,31-Dec-12,30,-3,27
664,GTI2012,SG1I14879601,C4P ,LIANG HUAT ALUMINIUM LTD,31-Dec-10,23,-13,10
531,GTI2011,SG1I14879601,C4P ,LIANG HUAT ALUMINIUM LTD,31-Dec-09,33,-12,21
633,GTI2010,SG1I14879601,C4P ,LIANG HUAT ALUMINIUM LTD,31-Dec-08,33,-15,18
529,GTI2009,SG1I14879601,C4P ,LIANG HUAT ALUMINIUM LTD,31-Dec-07,41,-15,26
396,GTI2013,SG1I14879601,C50 ,CHEUNG WOH TECHNOLOGIES LTD,28-Feb-12,34,-2,32
550,GTI2012,SG1I20879900,C50 ,CHEUNG WOH TECHNOLOGIES LTD,28-Feb-11,32,-8,24
254,GTI2011,SG1I20879900,C50 ,CHEUNG WOH TECHNOLOGIES LTD,28-Feb-10,38,-5,33
296,GTI2010,SG1I20879900,C50 ,CHEUNG WOH TECHNOLOGIES LTD,28-Feb-09,37,-3,34
82,GTI2009,SG1I20879900,C50 ,CHEUNG WOH TECHNOLOGIES LTD,28-Feb-08,43,0,43
35,GTI2013,SG1I20879900,C52 ,COMFORTDELGRO CORPORATION LTD,31-Dec-12,66,3,69
22,GTI2012,SG1I29881105,C52 ,COMFORTDELGRO CORP LTD,31-Dec-10,65,6,71
19,GTI2011,SG1I29881105,C52 ,COMFORTDELGRO CORPORATION LTD,31-Dec-09,61,8,69
20,GTI2010,SG1I29881105,C52 ,COMFORTDELGRO CORPORATION LTD,31-Dec-08,57,2,59
26,GTI2009,SG1I29881105,C52 ,COMFORTDELGRO CORPORATION LTD,31-Dec-07,58,-6,52
525,GTI2013,SG1I29881105,C59 ,CHINA FLEXIBLE PACK HLDG LTD,31-Oct-12,37,-10,27
500,GTI2012,SG1I31881119,C59 ,CHINA FLEXIBLE PACK HLDGS LTD,31-Oct-10,32,-6,26
430,GTI2011,SG1I31881119,C59 ,CHINA FLEXIBLE PACK HLDG LTD,31-Oct-09,31,-5,26
395,GTI2010,SG1I31881119,C59 ,CHINA FLEXIBLE PACK HLDG LTD,31-Oct-08,36,-5,31
407,GTI2009,SG1I31881119,C59 ,CHINA FLEXIBLE PACK HLDG LTD,31-Oct-07,39,-8,31
480,GTI2013,SG1I31881119,C60 ,AMPLEFIELD LIMITED,30-Sep-12,33,-4,29
379,GTI2012,SG1I37881659,C60 ,AMPLEFIELD LTD,30-Sep-11,33,-2,31
531,GTI2011,SG1I37881659,C60 ,AMPLEFIELD LIMITED,30-Sep-10,28,-7,21
608,GTI2010,SG1I37881659,C60 ,AMPLEFIELD LIMITED,30-Sep-08,21,0,21
529,GTI2009,SG1I37881659,C60 ,AMPLEFIELD LIMITED,31-Dec-07,26,0,26
430,GTI2013,SG1I37881659,C68 ,MIRACH ENERGY LIMITED,31-Dec-12,38,-7,31
355,GTI2012,SG1I40881829,C68 ,MIRACH ENERGY LTD,31-Dec-10,34,-2,32
458,GTI2011,SG1I40881829,C68 ,MIRACH ENERGY LIMITED,31-Dec-09,38,-13,25
498,GTI2010,SG1I40881829,C68 ,MIRACH ENERGY LIMITED,31-Dec-08,35,-8,27
442,GTI2009,SG1I40881829,C68 ,MIRACH ENERGY LIMITED (FORMERLY CHINA PETROTECH HOLDINGS LTD),31-Dec-07,36,-6,30
13,GTI2013,SG1I40881829,C6L ,SINGAPORE AIRLINES LTD,31-Mar-12,70,14,84
15,GTI2012,SG1I42881876,C6L ,SINGAPORE AIRLINES LTD,31-Mar-11,64,14,78
12,GTI2011,SG1I42881876,C6L ,SINGAPORE AIRLINES LTD,31-Mar-10,61,14,75
5,GTI2010,SG1I42881876,C6L ,SINGAPORE AIRLINES LTD,31-Mar-09,68,8,76
10,GTI2009,SG1I42881876,C6L ,SINGAPORE AIRLINES LTD,31-Mar-08,57,8,65
254,GTI2011,SG1I42881876,C71,CHINA PAPER HOLDINGS LIMITED,31-Dec-09,40,-7,33
235,GTI2010,SG1I44882534,C71,CHINA PAPER HOLDINGS LIMITED,31-Dec-08,39,-3,36
407,GTI2009,SG1I44882534,C71,CHINA PAPER HOLDINGS LIMITED,31-Dec-07,36,-5,31
544,GTI2013,SG1I44882534,C71 ,CHINA PAPER HOLDINGS LIMITED,31-Dec-11,46,-20,26
220,GTI2012,SG1I44882534,C71 ,CHINA PAPER HLDGS LTD,31-Dec-10,42,-5,37
450,GTI2013,SG1I44882534,C76 ,CREATIVE TECHNOLOGY LTD,30-Jun-12,35,-5,30
483,GTI2012,SG1I45882541,C76 ,CREATIVE TECHNOLOGY LTD,30-Jun-11,32,-5,27
254,GTI2011,SG1I45882541,C76 ,CREATIVE TECHNOLOGY LTD,30-Jun-10,38,-5,33
352,GTI2010,SG1I45882541,C76 ,CREATIVE TECHNOLOGY LTD,30-Jun-09,35,-3,32
630,GTI2013,SG1I45882541,C8R ,JIUTIAN CHEMICAL GROUP LIMITED,31-Dec-12,36,-17,19
646,GTI2012,SG1I46882631,C8R ,JIUTIAN CHEMICAL GROUP LTD,31-Dec-10,31,-15,16
567,GTI2011,SG1I46882631,C8R ,JIUTIAN CHEMICAL GROUP LIMITED,31-Dec-09,31,-13,18
498,GTI2010,SG1I46882631,C8R ,JIUTIAN CHEMICAL GROUP LIMITED,31-Dec-08,30,-3,27
442,GTI2009,SG1I46882631,C8R ,JIUTIAN CHEMICAL GROUP LIMITED,31-Dec-07,38,-8,30
480,GTI2013,SG1I46882631,C92 ,CHINA HAIDA LTD,31-Dec-12,29,0,29
317,GTI2012,SG1I47882655,C92 ,CHINA HAIDA LTD,31-Dec-10,32,1,33
301,GTI2011,SG1I47882655,C92 ,CHINA HAIDA LTD.,31-Dec-09,30,1,31
216,GTI2010,SG1I47882655,C92 ,CHINA HAIDA LTD.,31-Dec-08,34,3,37
266,GTI2009,SG1I47882655,C92 ,CHINA HAIDA LTD.,31-Dec-07,33,3,36
302,GTI2013,SG1I47882655,C9Q ,SINOSTAR PEC HOLDINGS LIMITED,31-Dec-12,35,1,36
196,GTI2012,SG1I47882655,C9Q ,SINOSTAR PEC HLDGS LTD,31-Dec-10,35,3,38
186,GTI2011,SG1I52882764,C9Q ,SINOSTAR PEC HOLDINGS LIMITED,31-Dec-09,35,1,36
129,GTI2010,SG1I52882764,C9Q ,SINOSTAR PEC HOLDINGS LIMITED,31-Dec-08,40,1,41
196,GTI2009,SG1I52882764,C9Q ,SINOSTAR PEC HOLDINGS LIMITED,31-Dec-07,37,1,38
18,GTI2013,SG1I52882764,CC3 ,STARHUB LTD,31-Dec-12,67,15,82
37,GTI2012,SG1I52882764,CC3 ,STARHUB LTD,31-Dec-10,54,6,60
28,GTI2011,SG1I53882771,CC3 ,STARHUB LTD,31-Dec-09,55,3,58
31,GTI2010,SG1I53882771,CC3 ,STARHUB LTD,31-Dec-08,53,0,53
22,GTI2009,SG1I53882771,CC3 ,STARHUB LTD,31-Dec-07,57,-3,54
52,GTI2013,SG1I53882771,CH8 ,CHINA SUNSINE CHEM HLDGS LTD,31-Dec-12,58,3,61
92,GTI2012,SG1I53882771,CH8 ,CHINA SUNSINE CHEMICAL HLDGS LTD,31-Dec-10,42,3,45
92,GTI2011,SG1I55882803,CH8 ,CHINA SUNSINE CHEM HLDGS LTD.,31-Dec-09,47,-5,42
82,GTI2010,SG1I55882803,CH8 ,CHINA SUNSINE CHEM HLDGS LTD.,31-Dec-08,46,-2,44
140,GTI2009,SG1I55882803,CH8 ,CHINA SUNSINE CHEM HLDGS LTD.,31-Dec-07,42,-2,40
654,GTI2009,SG1I55882803,CH8 ,CHINA SUN BIOCHEM TECH GP CO.,31-Dec-07,30,-15,15
373,GTI2013,SG1I55882803,CL7 ,R H ENERGY LTD.,31-Dec-12,38,-5,33
379,GTI2012,SG1I59882965,CL7 ,R H ENERGY LTD,31-Dec-10,31,0,31
407,GTI2011,SG1I59882965,CL7 ,R H ENERGY LTD.,31-Dec-09,27,0,27
417,GTI2010,SG1I59882965,CL7 ,R H ENERGY LTD.,31-Dec-08,32,-2,30
442,GTI2009,SG1I59882965,CL7 ,R H ENERGY LTD.,31-Dec-07,32,-2,30
57,GTI2013,SG1I59882965,CT1 ,AVI-TECH ELECTRONICS LIMITED,30-Jun-12,50,10,60
131,GTI2012,SG1I60882970,CT1 ,AVI-TECH ELECTRONICS LTD,30-Jun-11,44,-2,42
325,GTI2011,SG1I60882970,CT1 ,AVI-TECH ELECTRONICS LIMITED,30-Jun-10,34,-4,30
235,GTI2010,SG1I60882970,CT1 ,AVI-TECH ELECTRONICS LIMITED,30-Jun-09,38,-2,36
140,GTI2009,SG1I60882970,CT1 ,AVI-TECH ELECTRONICS LIMITED,30-Jun-08,42,-2,40
207,GTI2013,SG1I60882970,CX5 ,YONG XIN INTL HOLDINGS LTD,31-Dec-12,37,3,40
268,GTI2012,SG1I61883027,CX5 ,YONG XIN INTERNATIONAL HLDGS LTD,31-Dec-10,35,0,35
254,GTI2011,SG1I61883027,CX5 ,YONG XIN INTL HOLDINGS LTD.,31-Dec-09,39,-6,33
498,GTI2010,SG1I61883027,CX5 ,YONG XIN INTL HOLDINGS LTD.,31-Dec-08,36,-9,27
644,GTI2009,SG1I61883027,CX5 ,YONG XIN INTL HOLDINGS LTD.,31-Dec-07,32,-14,18
544,GTI2013,SG1I63883082,CZ3 ,SUNTAR ECO-CITY LIMITED,31-Dec-12,30,-4,26
659,GTI2012,SG1I63883082,CZ3 ,REYPHON AGRICEUTICAL LTD,31-Dec-10,26,-13,13
646,GTI2011,SG1I63883082,CZ3 ,REYPHON AGRICEUTICAL LIMITED,31-Dec-09,28,-23,5
659,GTI2010,SG1I63883082,CZ3 ,REYPHON AGRICEUTICAL LIMITED,31-Dec-08,30,-18,12
505,GTI2009,SG1I63883082,CZ3 ,REYPHON AGRICEUTICAL LIMITED,31-Dec-07,29,-2,27
588,GTI2013,SG1I64883495,CZ4 ,DUTECH HOLDINGS LIMITED,31-Dec-12,30,-7,23
483,GTI2012,SG1I64883495,CZ4 ,DUTECH HLDGS LTD,31-Dec-10,32,-5,27
430,GTI2011,SG1I64883495,CZ4 ,DUTECH HOLDINGS LIMITED,31-Dec-09,30,-4,26
417,GTI2010,SG1I64883495,CZ4 ,DUTECH HOLDINGS LIMITED,31-Dec-08,32,-2,30
463,GTI2009,SG1I64883495,CZ4 ,DUTECH HOLDINGS LIMITED,31-Dec-07,34,-5,29
23,GTI2013,SG1I65883502,D03 ,DEL MONTE PACIFIC LIMITED,31-Dec-12,65,14,79
61,GTI2012,SG1I65883502,D03 ,DEL MONTE PACIFIC LTD,31-Dec-10,54,-3,51
31,GTI2011,SG1I65883502,D03 ,DEL MONTE PACIFIC LIMITED,31-Dec-09,61,-5,56
33,GTI2010,SG1I65883502,D03 ,DEL MONTE PACIFIC LIMITED,31-Dec-08,57,-5,52
26,GTI2009,SG1I65883502,D03 ,DEL MONTE PACIFIC LIMITED,31-Dec-07,53,-1,52
326,GTI2013,SG1I67883666,D04 ,DATAPULSE TECHNOLOGY LIMITED,31-Jul-12,43,-8,35
410,GTI2012,SG1I67883666,D04 ,DATAPULSE TECHNOLOGY LTD,31-Jul-11,39,-9,30
618,GTI2011,SG1I67883666,D04 ,DATAPULSE TECHNOLOGY LIMITED,31-Jul-10,35,-22,13
543,GTI2010,SG1I67883666,D04 ,DATAPULSE TECHNOLOGY LIMITED,31-Jul-09,41,-16,25
574,GTI2009,SG1I67883666,D04 ,DATAPULSE TECHNOLOGY LIMITED,31-Jul-08,33,-9,24
7,GTI2013,SG1I69883698,D05 ,DBS GROUP HOLDINGS LTD,31-Dec-12,77,21,98
3,GTI2012,SG1I69883698,D05 ,DBS GROUP HLDGS LTD,31-Dec-10,77,17,94
9,GTI2011,SG1I69883698,D05 ,DBS GROUP HOLDINGS LTD,31-Dec-09,63,15,78
14,GTI2010,SG1I69883698,D05 ,DBS GROUP HOLDINGS LTD,31-Dec-08,55,12,67
6,GTI2009,SG1I69883698,D05 ,DBS GROUP HOLDINGS LTD,31-Dec-07,58,12,70
544,GTI2013,SG1I70883703,D08 ,DEVOTION ENERGY GROUP LIMITED,31-Dec-12,31,-5,26
611,GTI2012,SG1I70883703,D08 ,DEVOTION ENERGY GROUP LTD,31-Dec-10,28,-8,20
544,GTI2011,SG1I70883703,D08 ,DEVOTION ENERGY GROUP LIMITED,31-Dec-09,30,-10,20
417,GTI2010,SG1I70883703,D08 ,DEVOTION ENERGY GROUP LIMITED,31-Dec-08,33,-3,30
292,GTI2009,SG1I70883703,D08 ,DEVOTION ENERGY GROUP LIMITED,31-Dec-07,35,0,35
326,GTI2013,SG1I71883728,D11 ,DESIGN STUDIO FURNITURE MFRLTD,31-Dec-12,39,-4,35
379,GTI2012,SG1I71883728,D11 ,DESIGN STUDIO FURNITURE MANUFACTURER LTD,31-Dec-10,33,-2,31
281,GTI2011,SG1I71883728,D11 ,DESIGN STUDIO FURNITURE MFRLTD,31-Dec-09,37,-5,32
129,GTI2010,SG1I71883728,D11 ,DESIGN STUDIO FURNITURE MFRLTD,31-Dec-08,41,0,41
166,GTI2009,SG1I71883728,D11 ,DESIGN STUDIO FURNITURE MFRLTD,31-Dec-07,42,-3,39
33,GTI2013,SG1I76883822,D1R ,ARA ASSET MANAGEMENT LIMITED,31-Dec-12,63,9,72
156,GTI2012,SG1I76883822,D1R ,ARA ASSET MANAGEMENT LTD,31-Dec-10,40,0,40
92,GTI2011,SG1I76883822,D1R ,ARA ASSET MANAGEMENT LIMITED,31-Dec-09,44,-2,42
99,GTI2010,SG1I76883822,D1R ,ARA ASSET MANAGEMENT LIMITED,31-Dec-08,45,-2,43
292,GTI2009,SG1I76883822,D1R ,ARA ASSET MANAGEMENT LIMITED,31-Dec-07,38,-3,35
410,GTI2012,SG1I77884290,D2S,SC GLOBAL DEVELOPMENTS LTD,31-Dec-10,33,-3,30
210,GTI2011,SG1I77884290,D2S,SC GLOBAL DEVELOPMENTS LTD,31-Dec-09,38,-3,35
174,GTI2010,SG1I77884290,D2S,SC GLOBAL DEVELOPMENTS LTD,31-Dec-08,42,-3,39
82,GTI2009,SG1I77884290,D2S,SC GLOBAL DEVELOPMENTS LTD,31-Dec-07,43,0,43
533,GTI2012,SG1I77884290,D2U ,CACOLA FURNITURE INTERNATIONAL LTD,31-Dec-10,31,-6,25
254,GTI2011,SG1I78884307,D2U ,CACOLA FURNITURE INTL LIMITED,31-Dec-09,33,0,33
352,GTI2010,SG1I78884307,D2U ,CACOLA FURNITURE INTL LIMITED,31-Dec-08,32,0,32
196,GTI2009,SG1I78884307,D2U ,CACOLA FURNITURE INTL LIMITED,31-Dec-07,38,0,38
302,GTI2013,SG1I78884307,D2V ,CHANGTIAN PLASTIC & CHEM LTD,31-Dec-12,40,-4,36
268,GTI2012,SG1I78884307,D2V ,CHANGTIAN PLASTIC & CHEMICAL LTD,31-Dec-10,37,-2,35
186,GTI2011,SG1I79884330,D2V ,CHANGTIAN PLASTIC & CHEM LTD,31-Dec-09,43,-7,36
296,GTI2010,SG1I79884330,D2V ,CHANGTIAN PLASTIC & CHEM LTD,31-Dec-08,34,0,34
196,GTI2009,SG1I79884330,D2V ,CHANGTIAN PLASTIC & CHEM LTD,31-Dec-07,40,-2,38
639,GTI2013,SG1I79884330,D38 ,CDW HOLDING LIMITED,31-Dec-12,36,-18,18
641,GTI2012,SG1I79884330,D38 ,CDW HLDG LTD,31-Dec-10,32,-15,17
544,GTI2011,SG1I83884557,D38 ,CDW HOLDING LIMITED,31-Dec-09,34,-14,20
468,GTI2010,SG1I83884557,D38 ,CDW HOLDING LIMITED,31-Dec-08,35,-7,28
330,GTI2009,SG1I83884557,D38 ,CDW HOLDING LIMITED,31-Dec-07,41,-7,34
654,GTI2013,SG1I83884557,D3W ,SINOTEL TECHNOLOGIES LTD,31-Dec-12,38,-25,13
317,GTI2012,SG1I83884557,D3W ,SINOTEL TECHNOLOGIES LTD,31-Dec-10,35,-2,33
479,GTI2011,SG1I86884935,D3W ,SINOTEL TECHNOLOGIES LTD.,31-Dec-09,29,-5,24
524,GTI2010,SG1I86884935,D3W ,SINOTEL TECHNOLOGIES LTD.,31-Dec-08,31,-5,26
529,GTI2009,SG1I86884935,D3W ,SINOTEL TECHNOLOGIES LTD.,31-Dec-07,34,-8,26
91,GTI2013,SG1I86884935,D4N ,CHINA NEW TOWN DEVT CO LIMITED,31-Dec-12,49,2,51
115,GTI2012,SG1I86884935,D4N ,CHINA NEW TOWN DEVELOPMENT COMPANY LTD,31-Dec-10,48,-5,43
186,GTI2011,SG1I87884967,D4N ,CHINA NEW TOWN DEVT CO LIMITED,31-Dec-09,41,-5,36
33,GTI2010,SG1I87884967,D4N ,CHINA NEW TOWN DEVT CO LIMITED,31-Dec-08,49,3,52
111,GTI2009,SG1I87884967,D4N ,CHINA NEW TOWN DEVT CO LIMITED,31-Dec-07,41,0,41
621,GTI2013,SG1I87884967,D50 ,CHINA GREAT LAND HOLDINGS LTD.,31-Dec-11,34,-14,20
565,GTI2012,SG1I87884967,D50 ,CHINA GREAT LAND HLDGS LTD,31-Dec-10,30,-7,23
642,GTI2011,SG1I88884982,D50 ,CHINA GREAT LAND HOLDINGS LTD.,31-Dec-09,32,-26,6
652,GTI2010,SG1I88884982,D50 ,CHINA GREAT LAND HOLDINGS LTD.,31-Dec-08,25,-11,14
463,GTI2009,SG1I88884982,D50 ,CHINA GREAT LAND HOLDINGS LTD.,31-Dec-07,34,-5,29
450,GTI2013,SG1I88884982,D5N ,Z-OBEE HOLDINGS LIMITED,31-Mar-12,35,-5,30
410,GTI2012,SG1I88884982,D5N ,Z-OBEE HLDGS LTD,31-Mar-11,30,0,30
149,GTI2011,SG1I89885087,D5N ,Z-OBEE HOLDINGS LIMITED,31-Mar-10,34,4,38
129,GTI2010,SG1I89885087,D5N ,Z-OBEE HOLDINGS LIMITED,31-Mar-09,46,-5,41
196,GTI2009,SG1I89885087,D5N ,Z-OBEE HOLDINGS LIMITED,31-Mar-08,43,-5,38
252,GTI2013,SG1I89885087,D6U ,DYNAMIC COLOURS LIMITED,31-Dec-12,46,-8,38
565,GTI2012,SG1I89885087,D6U ,DYNAMIC COLOURS LTD,31-Dec-10,31,-8,23
430,GTI2011,SG1I94885148,D6U ,DYNAMIC COLOURS LIMITED,31-Dec-09,33,-7,26
267,GTI2010,SG1I94885148,D6U ,DYNAMIC COLOURS LIMITED,31-Dec-08,35,0,35
485,GTI2009,SG1I94885148,D6U ,DYNAMIC COLOURS LIMITED,31-Dec-07,30,-2,28
122,GTI2013,SG1I94885148,D79 ,C&G ENV PROTECT HLDGS LTD,31-Dec-12,52,-5,47
196,GTI2012,SG1I94885148,D79 ,C&G ENVIRONMENTAL PROTECTION  HLDGS LTD,31-Dec-10,44,-6,38
479,GTI2011,SG1I98885227,D79 ,C&G ENV PROTECT HLDGS LTD (FORMERLY C&G INDUSTRIAL HOLDINGS LTD),31-Dec-09,30,-6,24
352,GTI2010,SG1I98885227,D79 ,C&G INDUSTRIAL HOLDINGS LTD,31-Dec-08,32,0,32
292,GTI2009,SG1I98885227,D79 ,C&G INDUSTRIAL HOLDINGS LTD,31-Dec-07,38,-3,35
230,GTI2013,SG1I98885227,DC9 ,FUXING CHINA GROUP LIMITED,31-Dec-12,41,-2,39
131,GTI2012,SG1I98885227,DC9 ,FUXING CHINA GROUP LTD,31-Dec-10,42,0,42
210,GTI2011,SG1J04885492,DC9 ,FUXING CHINA GROUP LIMITED,31-Dec-09,37,-2,35
498,GTI2010,SG1J04885492,DC9 ,FUXING CHINA GROUP LIMITED,31-Dec-08,32,-5,27
442,GTI2009,SG1J04885492,DC9 ,FUXING CHINA GROUP LIMITED,31-Dec-07,33,-3,30
326,GTI2013,SG1J04885492,DM0 ,HANWELL HOLDINGS LIMITED,31-Dec-12,44,-9,35
410,GTI2012,SG1J04885492,DM0 ,PSC CORP LTD,31-Dec-10,39,-9,30
496,GTI2011,SG1J08885589,DM0 ,PSC  CORPORATION LTD,31-Dec-09,38,-15,23
296,GTI2010,SG1J08885589,DM0 ,PSC CORPORATION LTD,31-Dec-08,40,-6,34
574,GTI2009,SG1J08885589,DM0 ,PSC CORPORATION LTD,31-Dec-07,39,-15,24
544,GTI2013,SG1J08885589,DT2 ,CHINA OILFIELD TEC SVCS GRPLTD,31-Dec-12,34,-8,26
220,GTI2012,SG1J08885589,DT2 ,CHINA OILFIELD TECHNOLOGY SERVICES GROUP LTD,31-Dec-10,34,3,37
76,GTI2011,SG1J09885596,DT2 ,CHINA OILFIELD TEC SVCS GRPLTD,31-Dec-09,44,0,44
72,GTI2010,SG1J09885596,DT2 ,CHINA OILFIELD TEC SVCS GRPLTD,31-Dec-08,45,0,45
330,GTI2009,SG1J09885596,DT2 ,CHINA OILFIELD TEC SVCS GRPLTD,31-Dec-07,34,0,34
252,GTI2013,SG1J09885596,DU4 ,MERMAID MARITIME PUBLIC CO LTD,30-Sep-12,48,-10,38
46,GTI2012,SG1J09885596,DU4 ,MERMAID MARITIME PUBLIC CO LTD,30-Sep-11,56,-2,54
56,GTI2011,SG1J10885650,DU4 ,MERMAID MARITIME PUBLIC CO LTD,30-Sep-10,47,1,48
31,GTI2010,SG1J10885650,DU4 ,MERMAID MARITIME PUBLIC CO LTD,30-Sep-08,55,-2,53
26,GTI2009,SG1J10885650,DU4 ,MERMAID MARITIME PUBLIC CO LTD,30-Sep-07,52,0,52
132,GTI2013,SG1J10885650,E02 ,EU YAN SANG INTERNATIONAL LTD,30-Jun-12,43,3,46
436,GTI2012,SG1J10885650,E02 ,EU YAN SANG INTERNATIONAL LTD,30-Jun-11,37,-8,29
165,GTI2011,SG1J11885683,E02 ,EU YAN SANG INTERNATIONAL LTD,30-Jun-10,42,-5,37
57,GTI2010,SG1J11885683,E02 ,EU YAN SANG INTERNATIONAL LTD,30-Jun-09,47,0,47
70,GTI2009,SG1J11885683,E02 ,EU YAN SANG INTERNATIONAL LTD,30-Jun-08,49,-5,44
302,GTI2013,SG1J11885683,E13 ,ELLIPSIZ LTD,30-Jun-12,41,-5,36
355,GTI2012,SG1J11885683,E13 ,ELLIPSIZ LTD,30-Jun-11,42,-10,32
496,GTI2011,SG1J14885763,E13 ,ELLIPSIZ LTD,30-Jun-10,39,-16,23
323,GTI2010,SG1J14885763,E13 ,ELLIPSIZ LTD,30-Jun-09,39,-6,33
111,GTI2009,SG1J14885763,E13 ,ELLIPSIZ LTD,30-Jun-08,44,-3,41
174,GTI2013,SG1J14885763,E15 ,TRANSCU GROUP LIMITED,31-Mar-11,49,-7,42
281,GTI2011,SG1J14885763,E15 ,TRANSCU GROUP LIMITED,31-Mar-10,50,-18,32
115,GTI2010,SG1J17886040,E15 ,TRANSCU GROUP LIMITED,31-Mar-09,48,-6,42
292,GTI2009,SG1J17886040,E15 ,TRANSCU GROUP LTD (FORMERLY ENG WAH ORGANIZATION LIMITED),31-Mar-08,37,-2,35
122,GTI2013,SG1J17886040,E16 ,ELEC & ELTEK INT CO LTD,31-Dec-12,36,11,47
317,GTI2012,SG1J17886040,E16 ,ELEC & ELTEK INTERNATIONAL COMPANY LTD,31-Dec-10,33,0,33
430,GTI2011,SG1J17886040,E16 ,ELEC & ELTEK INT CO LTD,31-Dec-09,33,-7,26
115,GTI2010,SG1J19886816,E16 ,ELEC & ELTEK INT CO LTD,31-Dec-08,42,0,42
266,GTI2009,SG1J19886816,E16 ,ELEC & ELTEK INT CO LTD,31-Dec-07,32,4,36
230,GTI2013,SG1J19886816,E17 ,EXCELPOINT TECHNOLOGY LTD,31-Dec-12,41,-2,39
220,GTI2012,SG1J19886816,E17 ,EXCELPOINT TECHNOLOGY LTD,31-Dec-10,37,0,37
230,GTI2011,SG1J19886816,E17 ,EXCELPOINT TECHNOLOGY LTD,31-Dec-09,37,-3,34
174,GTI2010,SG1J21887414,E17 ,EXCELPOINT TECHNOLOGY LTD,31-Dec-08,41,-2,39
196,GTI2009,SG1J21887414,E17 ,EXCELPOINT TECHNOLOGY LTD,31-Dec-07,41,-3,38
396,GTI2013,SG1J21887414,E18 ,ECS HOLDINGS LIMITED,31-Dec-12,39,-7,32
483,GTI2012,SG1J21887414,E18 ,ECS HLDGS LTD,31-Dec-10,35,-8,27
567,GTI2011,SG1J21887414,E18 ,ECS HOLDINGS LIMITED,31-Dec-09,31,-13,18
608,GTI2010,SG1J23887768,E18 ,ECS HOLDINGS LIMITED,31-Dec-08,32,-11,21
463,GTI2009,SG1J23887768,E18 ,ECS HOLDINGS LIMITED,31-Dec-07,37,-8,29
326,GTI2013,SG1J23887768,E23 ,EUROPTRONIC GROUP LTD,31-Dec-12,37,-2,35
82,GTI2012,SG1J23887768,E23 ,EUROPTRONIC GROUP LTD,31-Dec-10,47,0,47
325,GTI2011,SG1J23887768,E23 ,EUROPTRONIC GROUP LTD,31-Dec-09,35,-5,30
352,GTI2010,SG1J24887775,E23 ,EUROPTRONIC GROUP LTD,31-Dec-08,35,-3,32
407,GTI2009,SG1J24887775,E23 ,EUROPTRONIC GROUP LTD,31-Dec-07,36,-5,31
353,GTI2013,SG1J24887775,E25 ,8TELECOM INTL HOLDINGS CO LTD,31-Dec-12,36,-2,34
500,GTI2012,SG1J24887775,E25 ,8TELECOM INTERNATIONAL HLDGS CO LTD,31-Dec-10,31,-5,26
531,GTI2011,SG1J24887775,E25 ,8TELECOM INTL HOLDINGS CO LTD,31-Dec-09,29,-8,21
524,GTI2010,SG1J26887955,E25 ,8TELECOM INTL HOLDINGS CO LTD,31-Dec-08,29,-3,26
505,GTI2009,SG1J26887955,E25 ,8TELECOM INTL HOLDINGS CO LTD,31-Dec-07,30,-3,27
185,GTI2013,SG1J26887955,E27 ,EUCON HOLDING LIMITED,31-Dec-12,43,-2,41
131,GTI2012,SG1J26887955,E27 ,EUCON HLDG LTD,31-Dec-10,45,-3,42
118,GTI2011,SG1J26887955,E27 ,EUCON HOLDING LIMITED,31-Dec-09,41,0,41
174,GTI2010,SG1J27887962,E27 ,EUCON HOLDING LIMITED,31-Dec-08,41,-2,39
97,GTI2009,SG1J27887962,E27 ,EUCON HOLDING LIMITED,31-Dec-07,48,-6,42
174,GTI2013,SG1J27887962,E28 ,FRENCKEN GROUP LIMITED,31-Dec-12,44,-2,42
82,GTI2012,SG1J27887962,E28 ,FRENCKEN GROUP LTD,31-Dec-10,49,-2,47
165,GTI2011,SG1J27887962,E28 ,FRENCKEN GROUP (FORMERLY ELECTROTECH INVESTMENTS LTD),31-Dec-09,42,-5,37
82,GTI2010,SG1J32888328,E28 ,FRENCKEN GROUP (FORMERLY ELECTROTECH INVESTMENTS LTD),31-Dec-08,43,1,44
111,GTI2009,SG1J32888328,E28 ,ELECTROTECH INVESTMENTS LTD,31-Dec-07,38,3,41
544,GTI2013,SG1J32888328,E3B ,WEE HUR HOLDINGS LTD,31-Dec-12,31,-5,26
455,GTI2012,SG1J32888328,E3B ,WEE HUR HLDGS LTD,31-Dec-10,31,-3,28
346,GTI2011,SG1J32888328,E3B ,WEE HUR HOLDINGS LTD.,31-Dec-09,33,-4,29
524,GTI2010,SG1J35888424,E3B ,WEE HUR HOLDINGS LTD.,31-Dec-08,28,-2,26
574,GTI2009,SG1J35888424,E3B ,WEE HUR HOLDINGS LTD.,31-Dec-07,29,-5,24
162,GTI2013,SG1J35888424,E5H ,GOLDEN AGRI-RESOURCES LTD,31-Dec-12,51,-8,43
317,GTI2012,SG1J35888424,E5H ,GOLDEN AGRI-RESOURCES LTD,31-Dec-10,46,-13,33
129,GTI2011,SG1J35888424,E5H ,GOLDEN AGRI-RESOURCES LTD,31-Dec-09,45,-5,40
323,GTI2010,SG1J36888431,E5H ,GOLDEN AGRI-RESOURCES LTD,31-Dec-08,38,-5,33
196,GTI2009,SG1J36888431,E5H ,GOLDEN AGRI-RESOURCES LTD,31-Dec-07,48,-10,38
252,GTI2013,SG1J36888431,E5P ,THE HOUR GLASS LIMITED,31-Mar-12,38,0,38
242,GTI2012,SG1J36888431,E5P ,THE HOUR GLASS LTD,31-Mar-11,36,0,36
230,GTI2011,SG1J36888431,E5P ,THE HOUR GLASS LIMITED,31-Mar-10,37,-3,34
57,GTI2010,SG1J38888702,E5P ,THE HOUR GLASS LIMITED,31-Mar-09,47,0,47
357,GTI2009,SG1J38888702,E5P ,THE HOUR GLASS LIMITED,31-Mar-08,36,-3,33
326,GTI2013,SG1J38888702,E6A ,YONGMAO HOLDINGS LIMITED,31-Mar-12,37,-2,35
355,GTI2012,SG1J38888702,E6A ,YONGMAO HLDGS LTD,31-Mar-11,31,1,32
301,GTI2011,SG1J38888702,E6A ,YONGMAO HOLDINGS LIMITED,31-Mar-10,32,-1,31
267,GTI2010,SG1J41888780,E6A ,YONGMAO HOLDINGS LIMITED,31-Mar-09,37,-2,35
266,GTI2009,SG1J41888780,E6A ,YONGMAO HOLDINGS LIMITED,31-Mar-08,38,-2,36
145,GTI2013,SG1J41888780,E6E ,SOUND GLOBAL LTD,31-Dec-12,47,-2,45
73,GTI2012,SG1J41888780,E6E ,SOUND GLOBAL LTD,31-Dec-11,49,0,49
76,GTI2011,SG1J41888780,E6E ,SOUND GLOBAL LTD. (FORMERLY EPURE INTERNATIONAL LTD),31-Dec-09,41,3,44
53,GTI2009,SG1J45001547,E6E ,EPURE INTERNATIONAL LTD.,31-Dec-07,46,0,46
115,GTI2013,SG1J45001547,E6R ,SAMKO TIMBER LIMITED,31-Dec-12,41,7,48
317,GTI2012,SG1J45001547,E6R ,SAMKO TIMBER LTD,31-Dec-10,35,-2,33
458,GTI2011,SG1J45001547,E6R ,SAMKO TIMBER LIMITED,31-Dec-09,31,-6,25
468,GTI2010,SG1J45001547,E6R ,SAMKO TIMBER LIMITED,31-Dec-08,30,-2,28
558,GTI2009,SG1J47889782,E6R ,SAMKO TIMBER LIMITED,31-Dec-07,30,-5,25
185,GTI2013,SG1J47889782,E8Z ,ROXY-PACIFIC HOLDINGS LIMITED,31-Dec-12,41,0,41
196,GTI2012,SG1J47889782,E8Z ,ROXY-PACIFIC HLDGS LTD,31-Dec-10,38,0,38
140,GTI2011,SG1J47889782,E8Z ,ROXY-PACIFIC HOLDINGS LIMITED,31-Dec-09,38,1,39
267,GTI2010,SG1J47889782,E8Z ,ROXY-PACIFIC HOLDINGS LIMITED,31-Dec-08,32,3,35
292,GTI2009,SG1J49001550,E8Z ,ROXY-PACIFIC HOLDINGS LIMITED,31-Dec-07,32,3,35
496,GTI2011,SG1J49001550,E90 ,"CHINA SKY CHEM FIBRE CO., LTD.",31-Dec-09,32,-9,23
352,GTI2010,SG1J49001550,E90 ,"CHINA SKY CHEM FIBRE CO., LTD.",31-Dec-08,40,-8,32
266,GTI2009,SG1J49001550,E90 ,"CHINA SKY CHEM FIBRE CO., LTD.",31-Dec-07,42,-6,36
162,GTI2013,SG1J49001550,E91 ,COURAGE MARINE GROUP LIMITED,31-Dec-12,40,3,43
242,GTI2012,SG1J51890098,E91 ,COURAGE MARINE GROUP LTD,31-Dec-10,36,0,36
165,GTI2011,SG1J51890098,E91 ,COURAGE MARINE GROUP LIMITED,31-Dec-09,37,0,37
82,GTI2010,SG1J51890098,E91 ,COURAGE MARINE GROUP LIMITED,31-Dec-08,44,0,44
196,GTI2009,SG1J51890098,E91 ,COURAGE MARINE GROUP LIMITED,31-Dec-07,41,-3,38
252,GTI2013,SG1J51890098,E94 ,LIZHONG WHEEL GROUP LTD,31-Dec-12,37,1,38
156,GTI2012,SG1J53890229,E94 ,LIZHONG WHEEL GROUP LTD,31-Dec-10,36,4,40
165,GTI2011,SG1J53890229,E94 ,LIZHONG WHEEL GROUP LTD.,31-Dec-09,36,1,37
296,GTI2010,SG1J53890229,E94 ,LIZHONG WHEEL GROUP LTD.,31-Dec-08,33,1,34
111,GTI2009,SG1J53890229,E94 ,LIZHONG WHEEL GROUP LTD.,31-Dec-07,43,-2,41
396,GTI2013,SG1J53890229,E9A ,LI HENG CHEM FIBRE TECH LTD,31-Dec-12,36,-4,32
220,GTI2012,SG1J57890407,E9A ,LI HENG CHEM FIBRE TECHNOLOGIES LTD,31-Dec-10,37,0,37
149,GTI2011,SG1J57890407,E9A ,LI HENG CHEM FIBRE TECH LTD,31-Dec-09,40,-2,38
267,GTI2010,SG1J57890407,E9A ,LI HENG CHEM FIBRE TECH LTD,31-Dec-08,37,-2,35
649,GTI2013,SG1J57890407,E9L ,JOYAS INTERNATIONAL HLDGS LTD,31-Dec-12,25,-10,15
587,GTI2012,SG1J57890407,E9L ,JOYAS INTERNATIONAL HLDGS LTD,31-Dec-10,24,-2,22
575,GTI2011,SG1J59890504,E9L ,JOYAS INTERNATIONAL HLDGS LTD,31-Dec-09,27,-10,17
608,GTI2010,SG1J59890504,E9L ,JOYAS INTERNATIONAL HLDGS LTD,31-Dec-08,26,-5,21
529,GTI2009,SG1J59890504,E9L ,JOYAS INTERNATIONAL HLDGS LTD,31-Dec-07,31,-5,26
60,GTI2013,SG1J59890504,EB5 ,FIRST RESOURCES LIMITED,31-Dec-12,56,3,59
66,GTI2012,SG1J59890504,EB5 ,FIRST RESOURCES LTD,31-Dec-10,53,-3,50
46,GTI2011,SG1J65890803,EB5 ,FIRST RESOURCES LIMITED,31-Dec-09,53,-3,50
216,GTI2010,SG1J65890803,EB5 ,FIRST RESOURCES LIMITED,31-Dec-08,42,-5,37
357,GTI2009,SG1J65890803,EB5 ,FIRST RESOURCES LIMITED,31-Dec-07,36,-3,33
450,GTI2013,SG1J65890803,EB7 ,KTL GLOBAL LIMITED,30-Jun-12,34,-4,30
292,GTI2012,SG1J65890803,EB7 ,KTL GLOBAL LTD,30-Jun-11,36,-2,34
140,GTI2011,SG1J68891147,EB7 ,KTL GLOBAL LIMITED,30-Jun-10,38,1,39
82,GTI2010,SG1J68891147,EB7 ,KTL GLOBAL LIMITED,30-Jun-09,43,1,44
70,GTI2009,SG1J68891147,EB7 ,KTL GLOBAL LIMITED,30-Jun-08,43,1,44
62,GTI2013,SG1J68891147,EE6 ,MERCATOR LINES (SINGAPORE) LIMITED,31-Mar-12,51,7,58
20,GTI2012,SG1J68891147,EE6 ,MERCATOR LINES (S) LTD,31-Mar-11,62,12,74
38,GTI2011,SG1J70891671,EE6 ,MERCATOR LINES (SINGAPORE) LTD,31-Mar-10,48,6,54
23,GTI2010,SG1J70891671,EE6 ,MERCATOR LINES (SINGAPORE) LTD,31-Mar-09,51,6,57
266,GTI2009,SG1J70891671,EE6 ,MERCATOR LINES (SINGAPORE) LTD,31-Mar-08,33,3,36
621,GTI2013,SG1J70891671,EG0 ,JES INTERNATIONAL HOLDINGS LTD,31-Dec-12,29,-9,20
483,GTI2012,SG1J70891671,EG0 ,JES INTERNATIONAL HLDGS LTD,31-Dec-10,30,-3,27
346,GTI2011,SG1J71891696,EG0 ,JES INTERNATIONAL HOLDINGS LTD,31-Dec-09,29,0,29
235,GTI2010,SG1J71891696,EG0 ,JES INTERNATIONAL HOLDINGS LTD,31-Dec-08,30,6,36
196,GTI2009,SG1J71891696,EG0 ,JES INTERNATIONAL HOLDINGS LTD,31-Dec-07,40,-2,38
230,GTI2013,SG1J71891696,EP4,CHINA ANIMAL HEALTHCARE LTD,31-Dec-12,39,0,39
156,GTI2012,SG1J71891696,EP4,CHINA ANIMAL HEALTHCARE LTD,31-Dec-10,39,1,40
186,GTI2011,SG1J72891703,EP4,CHINA ANIMAL HEALTHCARE LTD.,31-Dec-09,46,-10,36
148,GTI2010,SG1J72891703,EP4,CHINA ANIMAL HEALTHCARE LTD.,31-Dec-08,45,-5,40
326,GTI2013,SG1J72891703,ER0 ,KSH HOLDINGS LIMITED,31-Mar-12,39,-4,35
355,GTI2012,SG1J72891703,ER0 ,KSH HLDGS LTD,31-Mar-10,31,1,32
72,GTI2011,SG1J72891703,ER0 ,KSH HOLDINGS LIMITED,31-Mar-10,46,-1,45
196,GTI2010,SG1J89892363,ER0 ,KSH HOLDINGS LIMITED,31-Mar-09,37,1,38
228,GTI2009,SG1J89892363,ER0 ,KSH HOLDINGS LIMITED,31-Mar-08,36,1,37
396,GTI2013,SG1J89892363,F01 ,FREIGHT LINKS EXPRESS HOLDINGS LTD,30-Apr-12,34,-2,32
410,GTI2012,SG1J89892363,F01 ,FREIGHT LINKS EXPRESS HLDGS,30-Apr-11,32,-2,30
458,GTI2011,SG1J89892363,F01 ,FREIGHT LINKS EXPRESS HOLDINGS,30-Apr-10,27,-2,25
235,GTI2010,SG1J94892465,F01 ,FREIGHT LINKS EXPRESS HOLDINGS,30-Apr-09,36,0,36
266,GTI2009,SG1J94892465,F01 ,FREIGHT LINKS EXPRESS HOLDINGS,30-Apr-08,38,-2,36
503,GTI2013,SG1J94892465,F03 ,FOOD EMPIRE HOLDINGS LIMITED,31-Dec-12,39,-11,28
611,GTI2012,SG1J94892465,F03 ,FOOD EMPIRE HLDGS LTD,31-Dec-10,36,-16,20
557,GTI2011,SG1J94892465,F03 ,FOOD EMPIRE HOLDINGS LIMITED,31-Dec-09,35,-16,19
586,GTI2010,SG1K10892752,F03 ,FOOD EMPIRE HOLDINGS LIMITED,31-Dec-08,36,-13,23
529,GTI2009,SG1K10892752,F03 ,FOOD EMPIRE HOLDINGS LIMITED,31-Dec-07,39,-13,26
302,GTI2013,SG1K10892752,F06 ,SUNMOON FOOD COMPANY LIMITED,31-Dec-12,38,-2,36
156,GTI2012,SG1K10892752,F06 ,SUNMOON FOOD COMPANY LTD,31-Dec-10,42,-2,40
210,GTI2011,SG1K10892752,F06 ,SUNMOON FOOD COMPANY LIMITED,31-Dec-09,37,-2,35
174,GTI2010,SG1K15893086,F06 ,SUNMOON FOOD COMPANY LIMITED,31-Dec-08,39,0,39
578,GTI2013,SG1K15893086,F07,FDS NETWORKS GROUP LTD,31-Dec-12,29,-5,24
455,GTI2012,SG1K15893086,F07,FDS NETWORKS GROUP LTD,31-Dec-10,33,-5,28
557,GTI2011,SG1K15893086,F07,FDS NETWORKS GROUP LTD,31-Dec-09,27,-8,19
468,GTI2010,SG1K15893086,F07,FDS NETWORKS GROUP LTD,31-Dec-08,28,0,28
505,GTI2009,SG1K16893192,F07,FDS NETWORKS GROUP LTD,31-Dec-07,32,-5,27
273,GTI2013,SG1K16893192,F10 ,F J BENJAMIN HOLDINGS LTD,30-Jun-12,42,-5,37
220,GTI2012,SG1K16893192,F10 ,F J BENJAMIN HLDGS LTD,30-Jun-11,37,0,37
129,GTI2011,SG1K16893192,F10 ,F J BENJAMIN HOLDINGS LTD,30-Jun-10,45,-5,40
296,GTI2010,SG1K16893192,F10 ,F J BENJAMIN HOLDINGS LTD,30-Jun-09,34,0,34
591,GTI2009,SG1K20894269,F10 ,F J BENJAMIN HOLDINGS LTD,30-Jun-08,32,-9,23
396,GTI2013,SG1K20894269,F11 ,FUNG CHOI MEDIA GROUP LIMITED,30-Jun-12,29,3,32
436,GTI2012,SG1K20894269,F11 ,FUNG CHOI MEDIA GROUP LTD,30-Jun-11,29,0,29
458,GTI2011,SG1K20894269,F11 ,FUNG CHOI MEDIA GROUP LIMITED,30-Jun-10,27,-2,25
323,GTI2010,SG1K20894269,F11 ,FUNG CHOI MEDIA GROUP LIMITED,30-Jun-09,33,0,33
442,GTI2009,SG1K23894456,F11 ,FUNG CHOI MEDIA GROUP LIMITED,30-Jun-08,35,-5,30
660,GTI2011,SG1K23894456,F12 ,FIBRECHEM TECHNOLOGIES LIMITED,.,4,-20,-16
656,GTI2010,SG1K23894456,F12 ,FIBRECHEM TECHNOLOGIES LIMITED,31-Dec-07,35,-22,13
629,GTI2009,SG1K23894456,F12 ,FIBRECHEM TECHNOLOGIES LIMITED,31-Dec-07,35,-15,20
353,GTI2013,SG1K23894456,F13 ,FU YU CORPORATION LTD,31-Dec-12,42,-8,34
565,GTI2012,SG1K25001639,F13 ,FU YU CORP LTD,31-Dec-10,35,-12,23
430,GTI2011,SG1K25001639,F13 ,FU YU CORPORATION LTD,31-Dec-09,37,-11,26
468,GTI2010,SG1K25001639,F13 ,FU YU CORPORATION LTD,31-Dec-08,36,-8,28
442,GTI2009,SG1K25001639,F13 ,FU YU CORPORATION LTD,31-Dec-07,35,-5,30
132,GTI2013,SG1K25001639,F17 ,GUOCOLAND LIMITED,30-Jun-12,46,0,46
177,GTI2012,SG1K31894969,F17 ,GUOCOLAND LTD,30-Jun-11,42,-3,39
92,GTI2011,SG1K31894969,F17 ,GUOCOLAND LIMITED,30-Jun-10,42,0,42
48,GTI2010,SG1K31894969,F17 ,GUOCOLAND LIMITED,30-Jun-09,45,3,48
357,GTI2009,SG1K31894969,F17 ,GUOCOLAND LIMITED,30-Jun-08,36,-3,33
450,GTI2013,SG1K31894969,F18 ,FULL APEX (HOLDINGS) LIMITED,31-Dec-12,36,-6,30
317,GTI2012,SG1K37001643,F18 ,FULL APEX (HLDGS) LTD,31-Dec-10,36,-3,33
557,GTI2011,SG1K37001643,F18 ,FULL APEX (HOLDINGS) LIMITED,31-Dec-09,34,-15,19
599,GTI2010,SG1K37001643,F18 ,FULL APEX (HOLDINGS) LIMITED,31-Dec-08,34,-12,22
591,GTI2009,SG1K37001643,F18 ,FULL APEX (HOLDINGS) LIMITED,31-Dec-07,38,-15,23
252,GTI2013,SG1K37001643,F1E ,LOW KENG HUAT (SINGAPORE) LTD,31-Jan-12,41,-3,38
177,GTI2012,SG1K49001656,F1E ,LOW KENG HUAT (S) LTD,31-Jan-11,39,0,39
230,GTI2011,SG1K49001656,F1E ,LOW KENG HUAT (SINGAPORE) LTD,31-Jan-10,37,-3,34
235,GTI2010,SG1K49001656,F1E ,LOW KENG HUAT (SINGAPORE) LTD,31-Jan-09,36,0,36
266,GTI2009,SG1K49001656,F1E ,LOW KENG HUAT (SINGAPORE) LTD,31-Jan-08,36,0,36
525,GTI2013,SG1K49001656,F20 ,FEDERAL INT(2000) LTD,31-Dec-12,33,-6,27
89,GTI2012,SG1K55001665,F20 ,FEDERAL INTERNATIONAL (2000) LTD,31-Dec-10,41,5,46
301,GTI2011,SG1K55001665,F20 ,FEDERAL INT(2000) LTD,31-Dec-09,39,-8,31
352,GTI2010,SG1K55001665,F20 ,FEDERAL INT(2000) LTD,31-Dec-08,32,0,32
383,GTI2009,SG1K55001665,F20 ,FEDERAL INT(2000) LTD,31-Dec-07,35,-3,32
450,GTI2013,SG1K63001673,F22 ,FISCHER TECH LTD,31-Mar-12,39,-9,30
455,GTI2012,SG1K63001673,F22 ,FISCHER TECH LTD,31-Mar-11,34,-6,28
346,GTI2011,SG1K63001673,F22 ,FISCHER TECH LTD,31-Mar-10,32,-3,29
524,GTI2010,SG1K63001673,F22 ,FISCHER TECH LTD,31-Mar-09,32,-6,26
166,GTI2009,SG1K66001688,F22 ,FISCHER TECH LTD,31-Mar-08,41,-2,39
91,GTI2013,SG1K66001688,F2X ,CHINA TAISAN TECH GRP HLDGSLTD,31-Dec-12,48,3,51
156,GTI2012,SG1K66001688,F2X ,CHINA TAISAN TECHNOLOGY GROUP HLDGS PTE LTD,31-Dec-10,43,-3,40
92,GTI2011,SG1K66001688,F2X ,CHINA TAISAN TECH GRP HLDGSLTD,31-Dec-09,42,0,42
148,GTI2010,SG1K66001688,F2X ,CHINA TAISAN TECH GRP HLDGSLTD,31-Dec-08,40,0,40
649,GTI2013,SG1L01001701,F31 ,FRAGRANCE GROUP LIMITED,31-Dec-12,27,-12,15
483,GTI2012,SG1L01001701,F31 ,FRAGRANCE GROUP LTD,31-Dec-10,26,1,27
346,GTI2011,SG1L01001701,F31 ,FRAGRANCE GROUP LIMITED,31-Dec-09,28,1,29
498,GTI2010,SG1L01001701,F31 ,FRAGRANCE GROUP LIMITED,31-Dec-08,26,1,27
383,GTI2009,SG1L01001701,F31 ,FRAGRANCE GROUP LIMITED,31-Dec-07,31,1,32
145,GTI2013,SG1L83897430,F34 ,WILMAR INTERNATIONAL LIMITED,31-Dec-12,65,-20,45
66,GTI2012,SG1L83897430,F34 ,WILMAR INTERNATIONAL LTD,31-Dec-10,56,-6,50
92,GTI2011,SG1L83897430,F34 ,WILMAR INTERNATIONAL LIMITED,31-Dec-09,45,-3,42
64,GTI2010,SG1L83897430,F34 ,WILMAR INTERNATIONAL LIMITED,31-Dec-08,43,3,46
61,GTI2009,SG1L83897430,F34 ,WILMAR INTERNATIONAL LIMITED,31-Dec-07,48,-3,45
230,GTI2013,SG1L96897898,F3V ,SINO CONSTRUCTION LIMITED,31-Dec-11,38,1,39
131,GTI2012,SG1L96897898,F3V ,SINO CONSTRUCTION LTD,31-Dec-10,39,3,42
301,GTI2011,SG1L96897898,F3V ,SINO CONSTRUCTION LIMITED,31-Dec-09,33,-2,31
323,GTI2010,SG1L96897898,F3V ,SINO CONSTRUCTION LIMITED,31-Dec-08,38,-5,33
396,GTI2013,SG1L96897898,F6D ,CHINA FIBRETECH LTD.,31-Dec-12,40,-8,32
292,GTI2012,SG1M01001924,F6D ,CHINA FIBRETECH LTD,31-Dec-10,39,-5,34
346,GTI2011,SG1M01001924,F6D ,CHINA FIBRETECH LTD.,31-Dec-09,33,-4,29
296,GTI2010,SG1M01001924,F6D ,CHINA FIBRETECH LTD.,31-Dec-08,36,-2,34
174,GTI2013,SG1M01001924,F83 ,COSCO CORPORATION (S) LTD,31-Dec-12,48,-6,42
115,GTI2012,SG1M01001924,F83 ,COSCO CORP (S) LTD,31-Dec-10,43,0,43
129,GTI2011,SG1M03899564,F83 ,COSCO CORPORATION (S) LTD,31-Dec-09,48,-8,40
148,GTI2010,SG1M03899564,F83 ,COSCO CORPORATION (S) LTD,31-Dec-08,52,-12,40
266,GTI2009,SG1M03899564,F83 ,COSCO CORPORATION (S) LTD,31-Dec-07,48,-12,36
566,GTI2013,SG1M03899564,F86 ,COUGAR LOGISTICS CORPORATION LTD,31-Mar-12,27,-2,25
455,GTI2012,SG1M03899564,F86 ,COUGAR LOGISTICS CORP LTD,31-Mar-11,31,-3,28
479,GTI2011,SG1M04001939,F86 ,COUGAR LOGISTICS CORPN LTD,31-Mar-10,29,-5,24
323,GTI2010,SG1M04001939,F86 ,COUGAR LOGISTICS CORPN LTD,31-Mar-09,33,0,33
292,GTI2009,SG1M04001939,F86 ,COUGAR LOGISTICS CORPN LTD,31-Mar-08,37,-2,35
13,GTI2013,SG1M04001939,F99 ,"FRASER AND NEAVE, LIMITED",30-Sep-12,75,9,84
9,GTI2012,SG1M04001939,F99 ,FRASER AND NEAVE LTD,30-Sep-11,77,6,83
7,GTI2011,SG1M06899645,F99 ,FRASER AND NEAVE,30-Sep-10,78,6,84
14,GTI2009,SG1M06899645,F99 ,"FRASER AND NEAVE, LIMITED",30-Sep-08,59,-3,56
207,GTI2013,SG1M06899645,F9D ,BOUSTEAD SINGAPORE LIMITED,31-Mar-12,48,-8,40
177,GTI2012,SG1M06899645,F9D ,BOUSTEAD SINGAPORE LTD,31-Mar-11,44,-5,39
281,GTI2011,SG1M22901755,F9D ,BOUSTEAD SINGAPORE LIMITED,31-Mar-10,43,-11,32
148,GTI2010,SG1M22901755,F9D ,BOUSTEAD SINGAPORE LIMITED,31-Mar-09,43,-3,40
82,GTI2009,SG1M22901755,F9D ,BOUSTEAD SINGAPORE LIMITED,31-Mar-08,46,-3,43
326,GTI2013,SG1M22901755,F9M ,KENCANA AGRI LIMITED,31-Dec-12,32,3,35
220,GTI2012,SG1M22901755,F9M ,KENCANA AGRI LTD,31-Dec-10,34,3,37
62,GTI2011,SG1M24902538,F9M ,KENCANA AGRI LIMITED,31-Dec-09,44,3,47
352,GTI2010,SG1M24902538,F9M ,KENCANA AGRI LIMITED,31-Dec-08,32,0,32
74,GTI2013,SG1M24902538,FO8 ,ERATAT LIFESTYLE LIMITED,31-Dec-12,51,3,54
61,GTI2012,SG1M24902538,FO8 ,ERATAT LIFESTYLE LTD,31-Dec-10,51,0,51
52,GTI2011,SG1M24902538,FO8 ,ERATAT LIFESTYLE LIMITED (FORMERLY CHINA ERATAT SPORTS FASHIONLTD),31-Mar-10,49,0,49
40,GTI2010,SG1M25902545,FO8 ,CHINA ERATAT SPORTS FASHIONLTD,31-Mar-09,51,0,51
529,GTI2009,SG1M25902545,FO8 ,CHINA ERATAT SPORTS FASHIONLTD,31-Mar-08,26,0,26
612,GTI2013,SG1M25902545,FP1 ,DAPAI INTL HLDG CO. LTD,31-Dec-12,41,-20,21
611,GTI2012,SG1M25902545,FP1 ,DAPAI INTERNATIONAL HLDGS CO LTD,31-Dec-10,32,-12,20
186,GTI2011,SG1M25902545,FP1 ,DAPAI INTL HLDG CO. LTD. (FORMERLY CHINA ZAINO INTERNATIONAL LTD),31-Dec-09,38,-2,36
129,GTI2010,SG1M31001969,FP1 ,CHINA ZAINO INTERNATIONAL LTD,31-Dec-08,41,0,41
273,GTI2013,SG1M31001969,FQ7 ,JASPER INVESTMENTS LIMITED,31-Mar-12,31,6,37
436,GTI2012,SG1M31001969,FQ7 ,JASPER INVESTMENTS LTD,31-Mar-11,32,-3,29
557,GTI2011,SG1M31001969,FQ7 ,JASPER INVESTMENTS LIMITED,31-Mar-10,35,-16,19
417,GTI2010,SG1M31001969,FQ7 ,JASPER INVESTMENTS LIMITED,31-Mar-09,41,-11,30
97,GTI2009,SG1M32001976,FQ7 ,JASPER INVESTMENTS LIMITED,31-Mar-08,44,-2,42
77,GTI2013,SG1M32001976,FQ8 ,CHINA SPORTS INTL LIMITED,31-Dec-12,49,4,53
177,GTI2012,SG1M32001976,FQ8 ,CHINA SPORTS INTERNATIONAL LTD,31-Dec-10,39,0,39
72,GTI2011,SG1M32001976,FQ8 ,CHINA SPORTS INTL LIMITED,31-Dec-09,47,-2,45
174,GTI2010,SG1M32001976,FQ8 ,CHINA SPORTS INTL LIMITED,31-Dec-08,44,-5,39
266,GTI2009,SG1M34902643,FQ8 ,CHINA SPORTS INTL LIMITED,31-Dec-07,38,-2,36
185,GTI2013,SG1M34902643,FV2 ,HISAKA HOLDINGS LTD.,30-Sep-12,43,-2,41
500,GTI2012,SG1M34902643,FV2 ,HISAKA HLDGS LTD,30-Sep-11,28,-2,26
458,GTI2011,SG1M34902643,FV2 ,HISAKA HOLDINGS LTD.,30-Sep-10,32,-7,25
599,GTI2010,SG1M47904586,FV2 ,HISAKA HOLDINGS LTD.,30-Sep-08,24,-2,22
455,GTI2012,SG1M47904586,G03,BROTHERS (HLDGS) LTD,31-Mar-11,34,-6,28
458,GTI2011,SG1M47904586,G03,BROTHERS (HOLDINGS) LIMITED,31-Mar-10,33,-8,25
564,GTI2010,SG1M47904586,G03,BROTHERS (HOLDINGS) LIMITED,31-Dec-08,32,-8,24
644,GTI2009,SG1M47904586,G03,BROTHERS (HOLDINGS) LIMITED,31-Dec-07,26,-8,18
273,GTI2013,SG1M49904634,G05 ,GOODPACK LIMITED,30-Jun-12,48,-11,37
292,GTI2012,SG1M49904634,G05 ,GOODPACK LTD,30-Jun-11,37,-3,34
230,GTI2011,SG1M49904634,G05 ,GOODPACK LIMITED,30-Jun-10,42,-8,34
48,GTI2010,SG1M49904634,G05 ,GOODPACK LIMITED,30-Jun-09,53,-5,48
70,GTI2009,SG1M49904634,G05 ,GOODPACK LIMITED,30-Jun-08,44,0,44
25,GTI2013,SG1M53904744,G07 ,GREAT EASTERN HLDGS LTD,31-Dec-12,63,15,78
17,GTI2012,SG1M53904744,G07 ,GREAT EASTERN HLDGS LTD,31-Dec-10,70,6,76
28,GTI2011,SG1M53904744,G07 ,GREAT EASTERN HLDGS LTD,31-Dec-09,61,-3,58
18,GTI2010,SG1M53904744,G07 ,GREAT EASTERN HLDGS LTD,31-Dec-08,57,3,60
33,GTI2009,SG1M53904744,G07 ,GREAT EASTERN HLDGS LTD,31-Dec-07,51,0,51
273,GTI2013,SG1M54904800,G08 ,GP BATTERIES INTERNATIONAL LTD,31-Mar-12,41,-4,37
500,GTI2012,SG1M54904800,G08 ,GP BATTERIES INTERNATIONAL LTD,31-Mar-11,28,-2,26
496,GTI2011,SG1M54904800,G08 ,GP BATTERIES LIMITED,31-Mar-10,36,-13,23
352,GTI2010,SG1M54904800,G08 ,GP BATTERIES LIMITED,31-Mar-09,40,-8,32
615,GTI2009,SG1M54904800,G08 ,GP BATTERIES INT LTD,31-Mar-08,29,-8,21
35,GTI2012,SG1M55904841,G09,GUL TECHNOLOGIES SINGAPORE LTD,31-Dec-10,48,15,63
46,GTI2011,SG1M55904841,G09,GUL TECHNOLOGIES SINGAPORE LTD,31-Dec-09,44,6,50
196,GTI2010,SG1M55904841,G09,GUL TECHNOLOGIES SINGAPORE LTD,31-Dec-08,32,6,38
111,GTI2009,SG1M55904841,G09,GUL TECHNOLOGIES SINGAPORE LTD,31-Dec-07,38,3,41
450,GTI2013,SG1M55904841,G0I ,NAM LEE PRESSED METAL INDS LTD,30-Sep-12,37,-7,30
317,GTI2012,SG1M59904946,G0I ,NAM LEE PRESSED METAL INDS LTD,30-Sep-11,38,-5,33
514,GTI2011,SG1M59904946,G0I ,NAM LEE PRESSED METAL INDS LTD,30-Sep-10,32,-10,22
564,GTI2010,SG1M59904946,G0I ,NAM LEE PRESSED METAL INDS LTD,30-Sep-08,26,-2,24
615,GTI2009,SG1M59904946,G0I ,NAM LEE PRESSED METAL INDS LTD,30-Sep-07,26,-5,21
252,GTI2013,SG1M59904946,G13 ,GENTING SINGAPORE PLC,31-Dec-12,38,0,38
436,GTI2012,SG1M80907371,G13 ,GENTING SINGAPORE PLC,31-Dec-10,31,-2,29
479,GTI2011,SG1M80907371,G13 ,GENTING SINGAPORE PLC (FORMERLY GENTING INT'L PUBLIC LTD CO),31-Dec-09,29,-5,24
395,GTI2010,SG1M80907371,G13 ,GENTING SINGAPORE PLC,31-Dec-08,32,-1,31
588,GTI2013,SG1M80907371,G18 ,GRP LTD,30-Jun-12,28,-5,23
483,GTI2012,SG1M85907533,G18 ,GRP LTD,30-Jun-11,32,-5,27
567,GTI2011,SG1M85907533,G18 ,GRP LTD,30-Jun-10,22,-4,18
498,GTI2010,SG1M85907533,G18 ,GRP LTD,30-Jun-09,29,-2,27
505,GTI2009,SG1M85907533,G18 ,GRP LTD,30-Jun-08,29,-2,27
373,GTI2013,SG1M91002014,G20 ,GP INDUSTRIES LIMITED,31-Mar-12,40,-7,33
436,GTI2012,SG1M91002014,G20 ,GP INDUSTRIES LTD,31-Mar-11,37,-8,29
514,GTI2011,SG1M91002014,G20 ,GP INDUSTRIES LTD,31-Mar-10,38,-16,22
267,GTI2010,SG1M91002014,G20 ,GP INDUSTRIES LTD,31-Mar-09,43,-8,35
634,GTI2009,SG1M91002014,G20 ,GP INDUSTRIES LIMITED,31-Mar-08,30,-11,19
624,GTI2011,SG1M94907805,G21,GUANGZHAO IND FOREST BIOGRPLTD,31-Dec-09,34,-22,12
671,GTI2010,SG1M94907805,G21,GUANGZHAO IND FOREST BIOGRPLTD,31-Dec-08,36,-30,6
671,GTI2009,SG1M94907805,G21,GUANGZHAO IND FOREST BIOGRPLTD,31-Dec-07,39,-32,7
353,GTI2013,SG1M94907805,G31 ,GLOBAL TESTING CORPORATION LTD,31-Dec-12,37,-3,34
500,GTI2012,SG1M94907805,G31 ,GLOBAL TESTING CORP LTD,31-Dec-10,35,-9,26
588,GTI2011,SG1N00908623,G31 ,GLOBAL TESTING CORPORATION LTD,31-Dec-09,39,-23,16
447,GTI2010,SG1N00908623,G31 ,GLOBAL TESTING CORPORATION LTD,31-Dec-08,39,-10,29
463,GTI2009,SG1N00908623,G31 ,GLOBAL TESTING CORPORATION LTD,31-Dec-07,34,-5,29
230,GTI2013,SG1N00908623,G33,GUTHRIE GTS LTD,31-Dec-12,39,0,39
355,GTI2012,SG1N02002052,G33,GUTHRIE GTS LTD,30-Dec-10,35,-3,32
458,GTI2011,SG1N02002052,G33,GUTHRIE GTS LTD,31-Dec-09,31,-6,25
468,GTI2010,SG1N02002052,G33,GUTHRIE GTS LTD,31-Dec-08,28,0,28
591,GTI2009,SG1N02002052,G33,GUTHRIE GTS LTD,31-Dec-07,26,-3,23
326,GTI2013,SG1N02002052,G41 ,G. K. GOH HOLDINGS LIMITED,31-Dec-12,43,-8,35
105,GTI2012,SG1N09908665,G41 ,G. K. GOH HLDGS LTD,31-Dec-10,44,0,44
165,GTI2011,SG1N09908665,G41 ,G. K. GOH HOLDINGS LIMITED,31-Dec-09,42,-5,37
620,GTI2010,SG1N09908665,G41 ,G. K. GOH HOLDINGS LIMITED,31-Dec-08,28,-8,20
292,GTI2009,SG1N09908665,G41 ,G. K. GOH HOLDINGS LIMITED,31-Dec-07,43,-8,35
621,GTI2013,SG1N09908665,G4F ,OTTO MARINE LIMITED,31-Dec-12,44,-24,20
196,GTI2012,SG1N21908982,G4F ,OTTO MARINE LTD,31-Dec-10,46,-8,38
72,GTI2011,SG1N21908982,G4F ,OTTO MARINE LIMITED,31-Dec-09,44,1,45
99,GTI2010,SG1N21908982,G4F ,OTTO MARINE LIMITED,31-Dec-08,37,6,43
77,GTI2013,SG1N21908982,G50 ,GRAND BANKS YACHTS LIMITED,30-Jun-12,55,-2,53
115,GTI2012,SG1N21908982,G50 ,GRAND BANKS YACHTS LTD,30-Jun-11,40,3,43
186,GTI2011,SG1N22909146,G50 ,GRAND BANKS YACHTS LIMITED,30-Jun-10,39,-3,36
25,GTI2010,SG1N22909146,G50 ,GRAND BANKS YACHTS LIMITED,30-Jun-09,51,5,56
61,GTI2009,SG1N22909146,G50 ,GRAND BANKS YACHTS LIMITED,31-Mar-08,48,-3,45
373,GTI2013,SG1N22909146,G54 ,CHINA ESSENCE GROUP LTD.,31-Mar-12,43,-10,33
242,GTI2012,SG1N22909146,G54 ,CHINA ESSENCE GROUP LTD,31-Mar-11,41,-5,36
85,GTI2011,SG1N25909283,G54 ,CHINA ESSENCE GROUP LTD.,31-Mar-10,50,-7,43
64,GTI2010,SG1N25909283,G54 ,CHINA ESSENCE GROUP LTD.,31-Mar-09,51,-5,46
196,GTI2009,SG1N25909283,G54 ,CHINA ESSENCE GROUP LTD.,31-Mar-08,46,-8,38
174,GTI2013,SG1N25909283,G5X ,ANWELL TECHNOLOGIES LIMITED,31-Dec-12,44,-2,42
89,GTI2012,SG1N25909283,G5X ,ANWELL TECHNOLOGIES LTD,31-Dec-10,45,1,46
56,GTI2011,SG1N26909308,G5X ,ANWELL TECHNOLOGIES LIMITED,31-Dec-09,47,1,48
99,GTI2010,SG1N26909308,G5X ,ANWELL TECHNOLOGIES LIMITED,31-Dec-08,43,0,43
407,GTI2009,SG1N26909308,G5X ,ANWELL TECHNOLOGIES LIMITED,31-Dec-07,34,-3,31
647,GTI2013,SG1N26909308,G77 ,DIGILAND INTERNATIONAL LTD,30-Jun-12,25,-9,16
455,GTI2012,SG1N26909308,G77 ,DIGILAND INTERNATIONAL LTD,30-Jun-11,30,-2,28
430,GTI2011,SG1N28909355,G77 ,DIGILAND INTERNATIONAL LTD,30-Jun-10,33,-7,26
543,GTI2010,SG1N28909355,G77 ,DIGILAND INTERNATIONAL LTD,30-Jun-09,30,-5,25
407,GTI2009,SG1N28909355,G77 ,DIGILAND INTERNATIONAL LTD,30-Jun-08,30,1,31
611,GTI2011,SG1N28909355,G86 ,CHINA MILK PRODUCTS GROUP LTD,.,30,-16,14
586,GTI2010,SG1N28909355,G86 ,CHINA MILK PRODUCTS GROUP LTD,31-Mar-09,39,-16,23
166,GTI2009,SG1N31909426,G86 ,CHINA MILK PRODUCTS GROUP LTD,31-Mar-08,44,-5,39
36,GTI2013,SG1N31909426,G92 ,CHINA AVIATION OIL(S) CORP LTD,31-Dec-12,57,11,68
30,GTI2012,SG1N31909426,G92 ,CHINA AVIATION OIL(S) CORP LTD,31-Dec-10,57,9,66
31,GTI2011,SG1N31909426,G92 ,CHINA AVIATION OIL(S) CORP LTD,31-Dec-09,52,4,56
82,GTI2010,SG1N31909426,G92 ,CHINA AVIATION OIL(S) CORP LTD,31-Dec-08,51,-7,44
330,GTI2009,SG1N72002107,G92 ,CHINA AVIATION OIL(S) CORP LTD,31-Dec-07,49,-15,34
544,GTI2013,SG1N72002107,GG7 ,HAI LECK HOLDINGS LIMITED,30-Jun-12,34,-8,26
455,GTI2012,SG1N72002107,GG7 ,HAI LECK HLDGS LTD,30-Jun-11,34,-6,28
458,GTI2011,SG1N72002107,GG7 ,HAI LECK HOLDINGS LIMITED,30-Jun-10,32,-7,25
82,GTI2010,SG1N72002107,GG7 ,HAI LECK HOLDINGS LIMITED,30-Jun-09,46,-2,44
407,GTI2009,SG1N85910015,GG7 ,HAI LECK HOLDINGS LIMITED,30-Jun-08,36,-5,31
326,GTI2013,SG1N85910015,GH3,ASIA FASHION HOLDINGS LIMITED,31-Dec-12,45,-10,35
565,GTI2012,SG1N85910015,GH3,ASIA FASHION HLDGS LTD,31-Dec-10,25,-2,23
254,GTI2011,SG1N85910015,GH3,QIAN FENG FABRIC TECH LIMITED,31-Dec-09,33,0,33
148,GTI2010,SG1N85910015,GH3,QIAN FENG FABRIC TECH LIMITED,31-Dec-08,37,3,40
566,GTI2013,SG1N86910089,GJ8 ,DUKANG DISTILLERS HLDGS LTD,30-Jun-12,33,-8,25
455,GTI2012,SG1N86910089,GJ8 ,DUKANG DISTILLERS HLDGS LTD,30-Jun-11,28,0,28
281,GTI2011,SG1N86910089,GJ8 ,DUKANG DISTILLERS HLDGS LTD (FORMERLY TRUMP DRAGON DISTILLERS HLDGS),30-Jun-10,37,-5,32
447,GTI2010,SG1N86910089,GJ8 ,TRUMP DRAGON DISTILLERS HLDGS,30-Jun-09,31,-2,29
396,GTI2013,SG1N86910089,GU5 ,CHINA KUNDA TECHNOLOGY HOLDINGS LIMITED,31-Mar-12,34,-2,32
379,GTI2012,SG1N87910096,GU5 ,CHINA KUNDA TECHNOLOGY HLDGS LTD,31-Mar-11,33,-2,31
301,GTI2011,SG1N87910096,GU5 ,CHINA KUNDA TECH HOLDINGS LTD,31-Mar-10,35,-4,31
64,GTI2010,SG1N87910096,GU5 ,CHINA KUNDA TECH HOLDINGS LTD,31-Mar-09,48,-2,46
115,GTI2013,SG1N87910096,H02 ,HAW PAR CORP LTD,31-Dec-12,57,-9,48
115,GTI2012,SG1N87910096,H02 ,HAW PAR CORP LTD,31-Dec-10,52,-9,43
301,GTI2011,SG1N88910129,H02 ,HAW PAR CORP LTD,31-Dec-09,40,-9,31
468,GTI2010,SG1N88910129,H02 ,HAW PAR CORP LTD,31-Dec-08,40,-12,28
228,GTI2009,SG1N88910129,H02 ,HAW PAR CORP LTD,31-Dec-07,43,-6,37
544,GTI2013,SG1N88910129,H06 ,HOR KEW CORPORATION LIMITED,31-Dec-12,31,-5,26
436,GTI2012,SG1N88910129,H06 ,HOR KEW CORP LTD,31-Dec-10,32,-3,29
588,GTI2011,SG1N89910219,H06 ,HOR KEW CORPORATION LIMITED,31-Dec-09,30,-14,16
640,GTI2010,SG1N89910219,H06 ,HOR KEW CORPORATION LIMITED,31-Dec-08,27,-11,16
529,GTI2009,SG1N89910219,H06 ,HOR KEW CORPORATION LIMITED,31-Dec-07,34,-8,26
353,GTI2013,SG1N89910219,H07 ,STAMFORD LAND CORPORATION LTD,31-Mar-12,39,-5,34
177,GTI2012,SG1N89910219,H07 ,STAMFORD LAND CORP LTD,31-Mar-11,44,-5,39
346,GTI2011,SG1O02910816,H07 ,STAMFORD LAND CORPORATION LTD,31-Mar-10,34,-5,29
216,GTI2010,SG1O02910816,H07 ,STAMFORD LAND CORPORATION LTD,31-Mar-09,37,0,37
111,GTI2009,SG1O02910816,H07 ,STAMFORD LAND CORPORATION LTD,31-Mar-08,41,0,41
442,GTI2009,SG1O02910816,H07 ,STAMFORD TYRES CORPORATIONLTD,30-Apr-08,36,-6,30
102,GTI2013,SG1O02910816,H12 ,HOTEL ROYAL LTD,31-Dec-12,47,3,50
292,GTI2012,SG1O07910928,H12 ,HOTEL ROYAL LTD,31-Dec-10,34,0,34
301,GTI2011,SG1O07910928,H12 ,HOTEL ROYAL LTD,31-Dec-09,33,-2,31
395,GTI2010,SG1O07910928,H12 ,HOTEL ROYAL LTD,31-Dec-08,33,-2,31
266,GTI2009,SG1O07910928,H12 ,HOTEL ROYAL LTD,31-Dec-07,38,-2,36
102,GTI2013,SG1O07910928,H13 ,HO BEE INVESTMENT LIMITED,31-Dec-12,53,-3,50
196,GTI2012,SG1O09910991,H13 ,HO BEE INVESTMENT LTD,31-Dec-10,47,-9,38
325,GTI2011,SG1O09910991,H13 ,HO BEE INVESTMENT LIMITED,31-Dec-09,39,-9,30
468,GTI2010,SG1O09910991,H13 ,HO BEE INVESTMENT LIMITED,31-Dec-08,37,-9,28
407,GTI2009,SG1O09910991,H13 ,HO BEE INVESTMENT LIMITED,31-Dec-07,42,-11,31
396,GTI2013,SG1O09910991,H15 ,HOTEL PROPERTIES LTD,31-Dec-12,38,-6,32
379,GTI2012,SG1O10911046,H15 ,HOTEL PROPERTIES LTD,31-Dec-10,37,-6,31
514,GTI2011,SG1O10911046,H15 ,HOTEL PROPERTIES LTD,31-Dec-09,34,-12,22
468,GTI2010,SG1O10911046,H15 ,HOTEL PROPERTIES LTD,31-Dec-08,40,-12,28
383,GTI2009,SG1O10911046,H15 ,HOTEL PROPERTIES LTD,31-Dec-07,38,-6,32
566,GTI2013,SG1O10911046,H16 ,HUAN HSIN HOLDINGS LTD,31-Dec-12,30,-5,25
455,GTI2012,SG1O16911651,H16 ,HUAN HSIN HLDGS LTD,31-Dec-10,31,-3,28
458,GTI2011,SG1O16911651,H16 ,HUAN HSIN HOLDINGS LTD,31-Dec-09,33,-8,25
640,GTI2010,SG1O16911651,H16 ,HUAN HSIN HOLDINGS LTD,31-Dec-08,36,-20,16
529,GTI2009,SG1O16911651,H16 ,HUAN HSIN HOLDINGS LTD,31-Dec-07,34,-8,26
230,GTI2013,SG1O24911883,H17 ,HI-P INTERNATIONAL LIMITED,31-Dec-12,44,-5,39
177,GTI2012,SG1O24911883,H17 ,HI-P INTERNATIONAL LTD,31-Dec-10,41,-2,39
140,GTI2011,SG1O24911883,H17 ,HI-P INTERNATIONAL LIMITED,31-Dec-09,44,-5,39
148,GTI2010,SG1O24911883,H17 ,HI-P INTERNATIONAL LIMITED,31-Dec-08,48,-8,40
70,GTI2009,SG1O24911883,H17 ,HI-P INTERNATIONAL LIMITED,31-Dec-07,46,-2,44
578,GTI2013,SG1O27912029,H18 ,HOTEL GRAND CENTRAL LTD,31-Dec-12,23,1,24
668,GTI2012,SG1O27912029,H18 ,HOTEL GRAND CENTRAL LTD,31-Dec-10,19,-11,8
637,GTI2011,SG1O27912029,H18 ,HOTEL GRAND CENTRAL LTD,31-Dec-09,17,-8,9
640,GTI2010,SG1O27912029,H18 ,HOTEL GRAND CENTRAL LTD,31-Dec-08,19,-3,16
615,GTI2009,SG1O27912029,H18 ,HOTEL GRAND CENTRAL LTD,31-Dec-07,21,0,21
207,GTI2013,SG1O34912152,H19 ,HWA HONG CORPORATION LIMITED,31-Dec-12,43,-3,40
196,GTI2012,SG1O34912152,H19 ,HWA HONG CORP LTD,31-Dec-10,38,0,38
254,GTI2011,SG1O34912152,H19 ,HWA HONG CORPORATION LIMITED,31-Dec-09,36,-3,33
174,GTI2010,SG1O34912152,H19 ,HWA HONG CORPORATION LIMITED,31-Dec-08,39,0,39
166,GTI2009,SG1O34912152,H19 ,HWA HONG CORPORATION LIMITED,31-Dec-07,44,-5,39
544,GTI2013,SG1O38912554,H20 ,HOE LEONG CORPORATION LTD,31-Dec-12,32,-6,26
317,GTI2012,SG1O38912554,H20 ,HOE LEONG CORP LTD,31-Dec-10,30,3,33
430,GTI2011,SG1O38912554,H20 ,HOE LEONG CORPORATION LTD.,31-Dec-09,29,-3,26
564,GTI2010,SG1O38912554,H20 ,HOE LEONG CORPORATION LTD.,31-Dec-08,27,-3,24
357,GTI2009,SG1O38912554,H20 ,HOE LEONG CORPORATION LTD.,31-Dec-07,36,-3,33
52,GTI2013,SG1O42912715,H22 ,HONG LEONG ASIA LTD.,31-Dec-12,48,13,61
55,GTI2012,SG1O42912715,H22 ,HONG LEONG ASIA LTD,31-Dec-10,52,0,52
118,GTI2011,SG1O42912715,H22 ,HONG LEONG ASIA LTD.,31-Dec-09,44,-3,41
115,GTI2010,SG1O42912715,H22 ,HONG LEONG ASIA LTD.,31-Dec-08,45,-3,42
40,GTI2009,SG1O42912715,H22 ,HONG LEONG ASIA LTD.,31-Dec-07,51,-3,48
82,GTI2012,SG1O44912994,H23,EUNETWORKS GROUP LTD,31-Dec-10,49,-2,47
254,GTI2011,SG1O44912994,H23,EUNETWORKS GROUP LIMITED (Formerly Global Voice Group Ltd),31-Dec-09,47,-14,33
235,GTI2010,SG1O44912994,H23,EUNETWORKS GROUP LIMITED (Formerly Global Voice Group Ltd),31-Dec-08,44,-8,36
574,GTI2009,SG1O44912994,H23,GLOBAL VOICE GROUP LIMITED,31-Dec-07,29,-5,24
612,GTI2013,SG1O44912994,H27 ,HLH GROUP LIMITED,31-Dec-12,35,-14,21
410,GTI2012,SG1O45913009,H27 ,HLH GROUP LTD,31-Dec-10,35,-5,30
377,GTI2011,SG1O45913009,H27 ,HLH GROUP LIMITED,31-Dec-09,38,-10,28
564,GTI2010,SG1O45913009,H27 ,HLH GROUP LIMITED,31-Dec-08,35,-11,24
607,GTI2009,SG1O45913009,H27 ,HLH GROUP LIMITED,31-Dec-07,30,-8,22
533,GTI2012,SG1O45913009,H28,HERSING CORP LTD,31-Dec-10,36,-11,25
346,GTI2011,SG1O47913080,H28,HERSING CORPORATION LTD,31-Dec-09,37,-8,29
498,GTI2010,SG1O47913080,H28,HERSING CORPORATION LTD,31-Dec-08,32,-5,27
574,GTI2009,SG1O47913080,H28,HERSING CORPORATION LTD,31-Dec-07,29,-5,24
588,GTI2013,SG1O47913080,H30 ,HONG FOK CORPORATION LTD,31-Dec-12,31,-8,23
587,GTI2012,SG1O47913080,H30 ,HONG FOK CORP LTD,31-Dec-10,25,-3,22
407,GTI2011,SG1O53913362,H30 ,HONG FOK CORPORATION LTD,31-Dec-09,27,0,27
543,GTI2010,SG1O53913362,H30 ,HONG FOK CORPORATION LTD,31-Dec-08,25,0,25
330,GTI2009,SG1O53913362,H30 ,HONG FOK CORPORATION LTD,31-Dec-07,34,0,34
373,GTI2013,SG1O53913362,H49,PAN PACIFIC HOTELS GRP LIMITED,31-Dec-12,39,-6,33
66,GTI2012,SG1O55913907,H49,PAN PACIFIC HOTELS GROUP LTD,31-Dec-10,50,0,50
165,GTI2011,SG1O55913907,H49,PAN PACIFIC HOTELS GRP LIMITED (Formerly Hotel Plaza Ltd),31-Dec-09,43,-6,37
417,GTI2010,SG1O55913907,H49,PAN PACIFIC HOTELS GRP LIMITED (Formerly Hotel Plaza Ltd),31-Dec-08,33,-3,30
407,GTI2009,SG1O55913907,H49,HOTEL PLAZA LTD,31-Dec-07,34,-3,31
102,GTI2013,SG1O55913907,H64 ,HTL INT'L HOLDINGS LIMITED,31-Dec-12,53,-3,50
105,GTI2012,SG1O56913914,H64 ,HTL INTERNATIONAL HLDGS LTD,31-Dec-10,40,4,44
210,GTI2011,SG1O56913914,H64 ,HTL INT'L HOLDINGS LIMITED,31-Dec-09,51,-16,35
468,GTI2010,SG1O56913914,H64 ,HTL INT'L HOLDINGS LIMITED,31-Dec-08,36,-8,28
383,GTI2009,SG1O56913914,H64 ,HTL INT'L HOLDINGS LIMITED,31-Dec-07,37,-5,32
480,GTI2013,SG1O56913914,H73 ,HUPSTEEL LTD,30-Jun-12,34,-5,29
500,GTI2012,SG1O60914015,H73 ,HUPSTEEL LTD,30-Jun-11,39,-13,26
325,GTI2011,SG1O60914015,H73 ,HUPSTEEL LTD,30-Jun-10,41,-11,30
235,GTI2010,SG1O60914015,H73 ,HUPSTEEL LTD,30-Jun-09,45,-9,36
407,GTI2009,SG1O60914015,H73 ,HUPSTEEL LTD,30-Jun-08,45,-14,31
575,GTI2011,SG1O60914015,H80,HONGWEI TECHNOLOGIES LIMITED,31-Dec-09,31,-14,17
564,GTI2010,SG1O62914088,H80,HONGWEI TECHNOLOGIES LIMITED,31-Dec-08,26,-2,24
485,GTI2009,SG1O62914088,H80,HONGWEI TECHNOLOGIES LIMITED,31-Dec-07,33,-5,28
373,GTI2013,SG1O62914088,I03 ,INFORMATICS EDUCATION LTD.,31-Mar-12,35,-2,33
455,GTI2012,SG1O75914679,I03 ,INFORMATICS EDUCATION LTD,31-Mar-11,34,-6,28
377,GTI2011,SG1O75914679,I03 ,INFORMATICS EDUCATION LTD.,31-Mar-10,35,-7,28
216,GTI2010,SG1O75914679,I03 ,INFORMATICS EDUCATION LTD.,31-Mar-09,40,-3,37
505,GTI2009,SG1O75914679,I03 ,INFORMATICS EDUCATION LTD.,31-Mar-08,32,-5,27
252,GTI2013,SG1O75914679,I04 ,XPRESS HOLDINGS LTD,31-Jul-12,50,-12,38
317,GTI2012,SG1O81915033,I04 ,XPRESS HLDGS LTD,31-Jul-11,44,-11,33
377,GTI2011,SG1O81915033,I04 ,XPRESS HOLDINGS LTD,31-Jul-10,45,-17,28
564,GTI2010,SG1O81915033,I04 ,XPRESS HOLDINGS LTD,31-Jul-09,47,-23,24
644,GTI2009,SG1O81915033,I04 ,XPRESS HOLDINGS LTD,31-Jul-08,35,-17,18
326,GTI2013,SG1O81915033,I06 ,INTRACO LIMITED,31-Dec-12,35,0,35
483,GTI2012,SG1O83915098,I06 ,INTRACO LTD,31-Dec-10,30,-3,27
430,GTI2011,SG1O83915098,I06 ,INTRACO LIMITED,31-Dec-09,31,-5,26
620,GTI2010,SG1O83915098,I06 ,INTRACO LIMITED,31-Dec-08,28,-8,20
591,GTI2009,SG1O83915098,I06 ,INTRACO LIMITED,31-Dec-07,34,-11,23
230,GTI2013,SG1O83915098,I07 ,ISDN HOLDINGS LIMITED,31-Dec-12,42,-3,39
292,GTI2012,SG1O90915222,I07 ,ISDN HLDGS LTD,31-Dec-10,36,-2,34
325,GTI2011,SG1O90915222,I07 ,ISDN HOLDINGS LIMITED,31-Dec-09,32,-2,30
468,GTI2010,SG1O90915222,I07 ,ISDN HOLDINGS LIMITED,31-Dec-08,28,0,28
97,GTI2009,SG1O90915222,I07 ,ISDN HOLDINGS LIMITED,31-Dec-07,45,-3,42
373,GTI2013,SG1O90915222,I11 ,IPCO INTERNATIONAL LIMITED,30-Apr-12,35,-2,33
292,GTI2012,SG1O91915304,I11 ,IPCO INTERNATIONAL LTD,30-Apr-11,31,3,34
230,GTI2011,SG1O91915304,I11 ,IPCO INT'L LIMITED,30-Apr-10,33,1,34
196,GTI2010,SG1O91915304,I11 ,IPCO INT'L LIMITED,30-Apr-09,37,1,38
196,GTI2009,SG1O91915304,I11 ,IPCO INT'L LIMITED,30-Apr-08,37,1,38
598,GTI2013,SG1O91915304,I12 ,IPC CORPORATION LIMITED,31-Dec-12,35,-13,22
500,GTI2012,SG1O97915910,I12 ,IPC CORP LTD,31-Dec-10,34,-8,26
496,GTI2011,SG1O97915910,I12 ,IPC CORPORATION LIMITED,31-Dec-09,36,-13,23
395,GTI2010,SG1O97915910,I12 ,IPC CORPORATION LIMITED,31-Dec-08,37,-6,31
558,GTI2009,SG1O97915910,I12 ,IPC CORPORATION LIMITED,31-Dec-07,34,-9,25
62,GTI2013,SG1O97915910,I15 ,ISETAN (SINGAPORE) LTD,31-Dec-12,54,4,58
92,GTI2012,SG1O98915927,I15 ,ISETAN (S) LTD,31-Dec-10,42,3,45
377,GTI2011,SG1O98915927,I15 ,ISETAN (SINGAPORE) LTD,31-Dec-09,36,-8,28
498,GTI2010,SG1O98915927,I15 ,ISETAN (SINGAPORE) LTD,31-Dec-08,32,-5,27
607,GTI2009,SG1O98915927,I15 ,ISETAN (SINGAPORE) LTD,31-Dec-07,33,-11,22
450,GTI2013,SG1O98915927,I26 ,INNOPAC HOLDINGS LIMITED,31-Dec-12,36,-6,30
317,GTI2012,SG1P02915996,I26 ,INNO-PACIFIC HLDGS LTD,31-Dec-10,36,-3,33
230,GTI2011,SG1P02915996,I26 ,INNO-PACIFIC HOLDINGS LTD,31-Dec-09,39,-5,34
235,GTI2010,SG1P02915996,I26 ,INNO-PACIFIC HOLDINGS LTD,31-Dec-08,44,-8,36
228,GTI2009,SG1P02915996,I26 ,INNO-PACIFIC HOLDINGS LTD,31-Dec-07,39,-2,37
162,GTI2013,SG1P02915996,I49 ,IFS CAPITAL LIMITED,31-Dec-12,46,-3,43
156,GTI2012,SG1P04916067,I49 ,IFS CAPITAL LTD,31-Dec-10,43,-3,40
66,GTI2011,SG1P04916067,I49 ,IFS CAPITAL LIMITED,31-Dec-09,49,-3,46
174,GTI2010,SG1P04916067,I49 ,IFS CAPITAL LIMITED,31-Dec-08,42,-3,39
82,GTI2009,SG1P04916067,I49 ,IFS CAPITAL LIMITED,31-Dec-07,46,-3,43
373,GTI2013,SG1P04916067,I54 ,FABCHEM CHINA LIMITED,31-Mar-12,34,-1,33
317,GTI2012,SG1P05916231,I54 ,FABCHEM CHINA LTD,31-Mar-11,35,-2,33
301,GTI2011,SG1P05916231,I54 ,FABCHEM CHINA LIMITED,31-Mar-10,32,-1,31
129,GTI2010,SG1P05916231,I54 ,FABCHEM CHINA LIMITED,31-Mar-09,40,1,41
140,GTI2009,SG1P05916231,I54 ,FABCHEM CHINA LIMITED,31-Mar-08,40,0,40
630,GTI2013,SG1P05916231,I5H ,GREAT GROUP HOLDINGS LIMITED,31-Dec-12,30,-11,19
500,GTI2012,SG1P09916310,I5H ,GREAT GROUP HLDGS LTD,31-Dec-10,35,-9,26
207,GTI2013,SG1P09916310,I85 ,HENGXIN TECHNOLOGY LTD,31-Dec-12,42,-2,40
410,GTI2012,SG1P09916310,I85 ,HENGXIN TECHNOLOGY LTD,31-Dec-10,38,-8,30
514,GTI2011,SG1P09916310,I85 ,HENGXIN TECHNOLOGY LTD.,31-Dec-09,27,-5,22
468,GTI2010,SG1P09916310,I85 ,HENGXIN TECHNOLOGY LTD.,31-Dec-08,30,-2,28
383,GTI2009,SG1P12002132,I85 ,HENGXIN TECHNOLOGY LTD.,31-Dec-07,37,-5,32
207,GTI2013,SG1P12002132,I9T ,ZIWO HOLDINGS LTD,31-Dec-12,42,-2,40
410,GTI2012,SG1P12002132,I9T ,ZIWO HLDGS LTD,31-Dec-10,33,-3,30
598,GTI2013,SG1P12002132,IW5 ,SEROJA INVESTMENTS LIMITED,31-Dec-12,27,-5,22
410,GTI2012,SG1P12002132,IW5 ,SEROJA INVESTMENTS LTD,31-Dec-10,32,-2,30
496,GTI2011,SG1P13916389,IW5 ,SEROJA INVESTMENTS LIMITED (FORMERLY L & M GROUP INVESTMENTS LTD),31-Dec-09,28,-5,23
174,GTI2013,SG1P13916389,IX2 ,PEC LTD.,30-Jun-12,44,-2,42
92,GTI2012,SG1P13916389,IX2 ,PEC LTD,30-Jun-11,48,-3,45
353,GTI2013,SG1P13916389,J03 ,JADASON ENTERPRISES LTD,31-Dec-12,40,-6,34
500,GTI2012,SG1P13916389,J03 ,JADASON ENTERPRISES LTD,31-Dec-10,29,-3,26
407,GTI2011,SG1P15916395,J03 ,JADASON ENTERPRISES LTD,31-Dec-09,44,-17,27
417,GTI2010,SG1P15916395,J03 ,JADASON ENTERPRISES LTD,31-Dec-08,36,-6,30
292,GTI2009,SG1P15916395,J03 ,JADASON ENTERPRISES LTD,31-Dec-07,43,-8,35
273,GTI2013,SG1P15916395,J10 ,JAYA HOLDINGS LTD,30-Jun-12,37,0,37
379,GTI2012,SG1P15916395,J10 ,JAYA HLDGS LTD,30-Jun-11,31,0,31
301,GTI2011,SG1P16916402,J10 ,JAYA HOLDINGS LTD,30-Jun-10,33,-2,31
216,GTI2010,SG1P16916402,J10 ,JAYA HOLDINGS LTD,30-Jun-09,37,0,37
82,GTI2009,SG1P16916402,J10 ,JAYA HOLDINGS LTD,30-Jun-08,45,-2,43
588,GTI2013,SG1P16916402,J11 ,JACKS INTERNATIONAL LIMITED,31-Jan-12,22,1,23
565,GTI2012,SG1P16916402,J11 ,JACKS INTERNATIONAL LTD,31-Jan-11,22,1,23
575,GTI2011,SG1P24916816,J11 ,JACKS INTERNATIONAL LIMITED,31-Jan-10,19,-2,17
633,GTI2010,SG1P24916816,J11 ,JACKS INTERNATIONAL LIMITED,31-Jan-09,18,0,18
73,GTI2012,SG1P24916816,J15,JUKEN TECHNOLOGY LTD,31-Dec-10,46,3,49
85,GTI2011,SG1P24916816,J15,JUKEN TECHNOLOGY LIMITED,31-Dec-09,48,-5,43
148,GTI2010,SG1P24916816,J15,JUKEN TECHNOLOGY LIMITED,31-Dec-08,42,-2,40
140,GTI2009,SG1P25916898,J15,JUKEN TECHNOLOGY LIMITED,31-Dec-07,43,-3,40
132,GTI2013,SG1P25916898,J16 ,GSH CORPORATION LIMITED,31-Dec-12,42,4,46
105,GTI2012,SG1P25916898,J16 ,JEL CORP (HLDGS) LTD,31-Dec-10,41,3,44
407,GTI2011,SG1P25916898,J16 ,JEL CORPORATION (HOLDINGS) LTD,31-Dec-09,33,-6,27
656,GTI2010,SG1P29918163,J16 ,JEL CORPORATION (HOLDINGS) LTD,31-Dec-08,35,-22,13
615,GTI2009,SG1P29918163,J16 ,JEL CORPORATION (HOLDINGS) LTD,31-Dec-07,38,-17,21
430,GTI2013,SG1P29918163,J17 ,JACKSPEED CORPORATION LIMITED,29-Feb-12,34,-3,31
410,GTI2012,SG1P29918163,J17 ,JACKSPEED CORP LTD,28-Feb-11,30,0,30
377,GTI2011,SG1P29918163,J17 ,JACKSPEED CORPORATION LIMITED,28-Feb-10,37,-9,28
196,GTI2010,SG1P35918371,J17 ,JACKSPEED CORPORATION LIMITED,28-Feb-09,38,0,38
330,GTI2009,SG1P35918371,J17 ,JACKSPEED CORPORATION LIMITED,29-Feb-08,33,1,34
230,GTI2013,SG1P35918371,J18 ,CHINA JISHAN HOLDINGS LIMITED,31-Dec-12,39,0,39
355,GTI2012,SG1P35918371,J18 ,CHINA JISHAN HLDGS LTD,31-Dec-10,35,-3,32
230,GTI2011,SG1P35918371,J18 ,CHINA JISHAN HOLDINGS LIMITED,31-Dec-09,37,-3,34
417,GTI2010,SG1P40918440,J18 ,CHINA JISHAN HOLDINGS LIMITED,31-Dec-08,33,-3,30
442,GTI2009,SG1P40918440,J18 ,CHINA JISHAN HOLDINGS LIMITED (FORMERLY JISHAN HOLDINGS LTD),31-Dec-07,36,-6,30
458,GTI2011,SG1P40918440,J19,JETS TECHNICS INTL HLDGS LTD,31-May-10,24,1,25
296,GTI2010,SG1P40918440,J19,JETS TECHNICS INTL HLDGS LTD,31-May-09,28,6,34
330,GTI2009,SG1P40918440,J19,JETS TECHNICS INTL HLDGS LTD,31-May-08,31,3,34
230,GTI2013,SG1P64918631,J2T ,HOCK LIAN SENG HOLDINGS LTD,31-Dec-12,39,0,39
242,GTI2012,SG1P64918631,J2T ,HOCK LIAN SENG HLDGS LTD,31-Dec-10,38,-2,36
185,GTI2013,SG1P64918631,J74 ,PTERIS GLOBAL LIMITED,31-Dec-12,44,-3,41
61,GTI2012,SG1P64918631,J74 ,PTERIS GLOBAL LTD,31-Dec-10,51,0,51
52,GTI2011,SG1P64918631,J74 ,PTERIS GLOBAL LIMITED (FORMERLY INTER-ROLLER ENGINEERING LTD),31-Dec-09,52,-3,49
115,GTI2010,SG1P66918738,J74 ,PTERIS GLOBAL LIMITED (FORMERLY INTER-ROLLER ENGINEERING LTD),31-Dec-08,45,-3,42
166,GTI2009,SG1P66918738,J74 ,INTER-ROLLER ENGINEERING LTD,31-Dec-07,44,-5,39
41,GTI2013,SG1P66918738,J7X ,TIGER AIRWAYS HOLDINGS LIMITED,31-Mar-12,59,6,65
39,GTI2012,SG1P66918738,J7X ,TIGER AIRWAYS HLDGS LTD,31-Mar-11,55,3,58
252,GTI2013,SG1P66918738,J8O ,RYOBI KISO HOLDINGS LTD.,30-Jun-12,43,-5,38
550,GTI2012,SG1P68918835,J8O ,RYOBI KISO HLDGS LTD,30-Jun-11,32,-8,24
525,GTI2013,SG1P68918835,JA9 ,CHANGJIANG FERTILIZER HLGS LTD,31-Dec-12,35,-8,27
500,GTI2012,SG1P68918835,JA9 ,CHANGJIANG FERTILIZER HLDGS LTD,31-Dec-10,34,-8,26
115,GTI2013,SG1P68918835,JS5,SINO GRANDNESS FOOD IND GP LTD,31-Dec-12,44,4,48
73,GTI2012,SG1P68918835,JS5,SINO GRANDNESS FOOD INDUSTRY GROUP LTD,31-Dec-10,43,6,49
25,GTI2013,SG1P72918953,JS8 ,CAPITAMALLS ASIA LIMITED,31-Dec-12,72,6,78
73,GTI2012,SG1P72918953,JS8 ,CAPITAMALLS ASIA LTD,31-Dec-10,51,-2,49
122,GTI2013,SG1P72918953,K01 ,K1 VENTURES LIMITED,30-Jun-12,44,3,47
242,GTI2012,SG1P72918953,K01 ,K1 VENTURES LTD,30-Jun-11,33,3,36
186,GTI2011,SG1P72918953,K01 ,K1 VENTURES LIMITED,30-Jun-10,36,0,36
99,GTI2010,SG1P73919000,K01 ,K1 VENTURES LIMITED,30-Jun-09,40,3,43
196,GTI2009,SG1P73919000,K01 ,K1 VENTURES LIMITED,30-Jun-08,40,-2,38
578,GTI2013,SG1P73919000,K03 ,KHONG GUAN FLOUR MILLING LTD,31-Jul-12,32,-8,24
633,GTI2012,SG1P73919000,K03 ,KHONG GUAN FLOUR MILLING LTD,30-Apr-10,26,-8,18
557,GTI2011,SG1P73919000,K03 ,KHONG GUAN FLOUR MILLING LTD,30-Apr-10,24,-5,19
447,GTI2010,SG1P75919099,K03 ,KHONG GUAN FLOUR MILLING LTD,30-Apr-09,29,0,29
266,GTI2009,SG1P75919099,K03 ,KHONG GUAN FLOUR MILLING LTD,30-Apr-08,38,-2,36
373,GTI2013,SG1P75919099,K04,KIAN ANN ENGINEERING LTD,30-Jun-12,35,-2,33
92,GTI2012,SG1P75919099,K04,KIAN ANN ENGINEERING LTD,30-Jun-11,45,0,45
149,GTI2011,SG1P75919099,K04,KIAN ANN ENGINEERING LTD,30-Jun-10,43,-5,38
148,GTI2010,SG1P77919642,K04,KIAN ANN ENGINEERING LTD,30-Jun-09,43,-3,40
97,GTI2009,SG1P77919642,K04,KIAN ANN ENGINEERING LTD,30-Jun-08,47,-5,42
624,GTI2011,SG1P77919642,K07,KXD DIGITAL ENTERTAINMENT LTD,31-Dec-09,34,-22,12
395,GTI2010,SG1P81919679,K07,KXD DIGITAL ENTERTAINMENT LTD,31-Dec-08,33,-2,31
228,GTI2009,SG1P81919679,K07,KXD DIGITAL ENTERTAINMENT LTD,31-Dec-07,39,-2,37
15,GTI2013,SG1P81919679,K11 ,KEPPEL TELE & TRAN,31-Dec-12,74,9,83
13,GTI2012,SG1P81919679,K11 ,KEPPEL TELE & TRAN,31-Dec-10,69,12,81
17,GTI2011,SG1P81919679,K11 ,KEPPEL TELE & TRAN,31-Dec-09,64,6,70
9,GTI2010,SG1P85919766,K11 ,KEPPEL TELE & TRAN,31-Dec-08,68,6,74
3,GTI2009,SG1P85919766,K11 ,KEPPEL TELE & TRAN,31-Dec-07,68,9,77
647,GTI2013,SG1P85919766,K14 ,KINGBOARD COPPER FOIL HDGS LTD,31-Dec-12,33,-17,16
355,GTI2012,SG1P85919766,K14 ,KINGBOARD COPPER FOIL HLDGS LTD,31-Dec-10,32,0,32
588,GTI2011,SG1P85919766,K14 ,KINGBOARD COPPER FOIL HDGS LTD,31-Dec-09,26,-10,16
564,GTI2010,SG1P93919998,K14 ,KINGBOARD COPPER FOIL HDGS LTD,31-Dec-08,26,-2,24
383,GTI2009,SG1P93919998,K14 ,KINGBOARD COPPER FOIL HDGS LTD,31-Dec-07,34,-2,32
5,GTI2013,SG1P94920060,K17 ,KEPPEL LAND LIMITED,31-Dec-12,83,21,104
6,GTI2012,SG1P94920060,K17 ,KEPPEL LAND LTD,31-Dec-10,77,15,92
3,GTI2011,SG1P94920060,K17 ,KEPPEL LAND LIMITED,31-Dec-09,73,18,91
13,GTI2010,SG1P94920060,K17 ,KEPPEL LAND LIMITED,31-Dec-08,68,0,68
8,GTI2009,SG1P94920060,K17 ,KEPPEL LAND LIMITED,31-Dec-07,66,0,66
185,GTI2013,SG1P97920257,K1Q ,TTJ HOLDINGS LIMITED,31-Jul-12,46,-5,41
156,GTI2012,SG1P97920257,K1Q ,TTJ HLDGS LTD,31-Jul-11,39,1,40
273,GTI2013,SG1P97920257,K22 ,KIAN HO BEARINGS LTD,31-Dec-12,36,1,37
292,GTI2012,SG1P97920257,K22 ,KIAN HO BEARINGS LTD,31-Dec-10,36,-2,34
557,GTI2011,SG1P97920257,K22 ,KIAN HO BEARINGS LTD,31-Dec-09,34,-15,19
656,GTI2010,SG1Q02920318,K22 ,KIAN HO BEARINGS LTD,31-Dec-08,29,-16,13
292,GTI2009,SG1Q02920318,K22 ,KIAN HO BEARINGS LTD,31-Dec-07,41,-6,35
102,GTI2013,SG1Q02920318,K29 ,KARIN TECHNOLOGY HLDGS LIMITED,30-Jun-12,46,4,50
55,GTI2012,SG1Q02920318,K29 ,KARIN TECHNOLOGY HLDGS LTD,30-Jun-11,52,0,52
92,GTI2011,SG1Q02920318,K29 ,KARIN TECHNOLOGY HLDGS LIMITED,30-Jun-10,44,-2,42
82,GTI2010,SG1Q03920366,K29 ,KARIN TECHNOLOGY HLDGS LIMITED,30-Jun-09,49,-5,44
82,GTI2009,SG1Q03920366,K29 ,KARIN TECHNOLOGY HLDGS LIMITED,30-Jun-08,48,-5,43
273,GTI2013,SG1Q03920366,K2M ,DEBAO PROPERTY DEVELOPMENT LTD,31-Dec-12,37,0,37
156,GTI2012,SG1Q03920366,K2M ,DEBAO PROPERTY DEVELOPMENT LTD,31-Dec-10,40,0,40
132,GTI2013,SG1Q03920366,K2N ,CHINA MINZHONG FOOD CORP LTD,30-Jun-12,45,1,46
220,GTI2012,SG1Q04920423,K2N ,CHINA MINZHONG FOOD CORP LTD,30-Jun-11,42,-5,37
302,GTI2013,SG1Q04920423,K2P ,TIONG SENG HOLDINGS LIMITED,31-Dec-12,36,0,36
185,GTI2013,SG1Q04920423,K6J ,GLOBAL PALM RESOURCES HLGS LTD,31-Dec-12,46,-5,41
177,GTI2012,SG1Q04920423,K6J ,GLOBAL PALM RESOURCES HLDGS LTD,31-Dec-10,39,0,39
353,GTI2013,SG1Q04920423,K75 ,KOH BROTHERS GROUP LIMITED,31-Dec-12,37,-3,34
533,GTI2012,SG1Q09920634,K75 ,KOH BROTHERS GROUP LTD,31-Dec-10,30,-5,25
377,GTI2011,SG1Q09920634,K75 ,KOH BROTHERS GROUP LIMITED,31-Dec-09,37,-9,28
468,GTI2010,SG1Q09920634,K75 ,KOH BROTHERS GROUP LIMITED,31-Dec-08,34,-6,28
357,GTI2009,SG1Q09920634,K75 ,KOH BROTHERS GROUP LIMITED,31-Dec-07,36,-3,33
503,GTI2013,SG1Q09920634,KF4 ,SIN HENG HEAVY MACHINERY LTD,30-Jun-12,33,-5,28
317,GTI2012,SG1Q12920787,KF4 ,SIN HENG HEAVY MACHINERY LTD,30-Jun-11,35,-2,33
46,GTI2013,SG1Q12920787,KI3 ,HU AN CABLE HOLDINGS LTD,31-Dec-12,55,9,64
156,GTI2012,SG1Q12920787,KI3 ,HU AN CABLE HLDGS LTD,31-Dec-10,40,0,40
122,GTI2013,SG1Q12920787,KJ5 ,BBR HOLDINGS (S) LTD,31-Dec-12,44,3,47
177,GTI2012,SG1Q12920787,KJ5 ,BBR HLDGS (S) LTD,31-Dec-10,42,-3,39
140,GTI2011,SG1Q14921304,KJ5 ,BBR HOLDINGS (S) LTD,31-Dec-09,42,-3,39
48,GTI2010,SG1Q14921304,KJ5 ,BBR HOLDINGS (S) LTD,31-Dec-08,48,0,48
485,GTI2009,SG1Q14921304,KJ5 ,BBR HOLDINGS (S) LTD,31-Dec-07,34,-6,28
252,GTI2013,SG1Q14921304,KJ9 ,COGENT HOLDINGS LIMITED,31-Dec-12,42,-4,38
220,GTI2012,SG1Q14921304,KJ9 ,COGENT HLDGS LTD,31-Dec-10,37,0,37
480,GTI2013,SG1Q22921577,KT9 ,QINGMEI GROUP HOLDINGS LIMITED,30-Jun-12,36,-7,29
268,GTI2012,SG1Q22921577,KT9 ,QINGMEI GROUP HLDGS LTD,30-Jun-11,37,-2,35
598,GTI2013,SG1Q22921577,L02 ,MANHATTAN RESOURCES LIMITED,31-Dec-12,38,-16,22
379,GTI2012,SG1Q22921577,L02 ,MANHATTAN RESOURCES LTD,31-Dec-10,35,-4,31
210,GTI2011,SG1Q25921608,L02 ,MANHATTAN RESOURCES LIMITED,31-Dec-09,35,0,35
323,GTI2010,SG1Q25921608,L02 ,MANHATTAN RESOURCES LIMITED,31-Dec-08,30,3,33
292,GTI2009,SG1Q25921608,L02 ,MANHATTAN RESOURCES LIMITED,31-Dec-07,35,0,35
450,GTI2013,SG1Q25921608,L03 ,LIAN BENG GROUP LTD,31-May-12,35,-5,30
587,GTI2012,SG1Q25921608,L03 ,LIAN BENG GROUP LTD,31-May-11,25,-3,22
531,GTI2011,SG1Q30921981,L03 ,LIAN BENG GROUP LTD,31-May-10,29,-8,21
468,GTI2010,SG1Q30921981,L03 ,LIAN BENG GROUP LTD,31-May-09,33,-5,28
629,GTI2009,SG1Q30921981,L03 ,LIAN BENG GROUP LTD,31-May-08,25,-5,20
630,GTI2013,SG1Q30921981,L05 ,LAFE CORPORATION LIMITED,31-Dec-12,36,-17,19
673,GTI2012,SG1Q30921981,L05 ,LAFE CORP LTD,31-Dec-10,34,-30,4
629,GTI2011,SG1Q31922020,L05 ,LAFE CORPORATION LIMITED,31-Dec-09,34,-23,11
659,GTI2010,SG1Q31922020,L05 ,LAFE CORPORATION LIMITED,31-Dec-08,29,-17,12
615,GTI2009,SG1Q31922020,L05 ,LAFE CORPORATION LIMITED,31-Dec-07,31,-10,21
430,GTI2013,SG1Q31922020,L08 ,LION ASIAPAC LTD,30-Jun-12,34,-3,31
533,GTI2012,SG1Q31922020,L08 ,LION ASIAPAC LTD,30-Jun-11,39,-14,25
588,GTI2011,SG1Q38922098,L08 ,LION ASIAPAC LTD,30-Jun-10,35,-19,16
99,GTI2010,SG1Q38922098,L08 ,LION ASIAPAC LTD,30-Jun-09,46,-3,43
407,GTI2009,SG1Q38922098,L08 ,LION ASIAPAC LTD,30-Jun-08,34,-3,31
185,GTI2013,SG1Q38922098,L10 ,LHT HOLDINGS LIMITED,31-Dec-12,49,-8,41
131,GTI2012,SG1Q38922098,L10 ,LHT HLDGS LTD,31-Dec-10,48,-6,42
92,GTI2011,SG1Q39922105,L10 ,LHT HOLDINGS LIMITED,31-Dec-09,47,-5,42
115,GTI2010,SG1Q39922105,L10 ,LHT HOLDINGS LIMITED,31-Dec-08,47,-5,42
166,GTI2009,SG1Q39922105,L10 ,LHT HOLDINGS LIMITED,31-Dec-07,44,-5,39
525,GTI2013,SG1Q39922105,L15 ,LINDETEVES-JACOBERG LTD,31-Dec-12,32,-5,27
602,GTI2012,SG1Q39922105,L15 ,LINDETEVES-JACOBERG LTD,31-Dec-10,21,0,21
642,GTI2011,SG1Q40922128,L15 ,LINDETEVES-JACOBERG LTD,31-Dec-09,16,-10,6
675,GTI2010,SG1Q40922128,L15 ,LINDETEVES-JACOBERG LTD,31-Dec-08,14,-14,0
671,GTI2009,SG1Q40922128,L15 ,LINDETEVES-JACOBERG LTD,31-Dec-07,18,-11,7
503,GTI2013,SG1Q40922128,L17 ,LION TECK CHIANG LTD,30-Jun-12,34,-6,28
656,GTI2012,SG1Q40922128,L17 ,LION TECK CHIANG LTD,30-Jun-11,31,-17,14
588,GTI2011,SG1Q42922142,L17 ,LION TECK CHIANG LTD,30-Jun-10,35,-19,16
267,GTI2010,SG1Q42922142,L17 ,LION TECK CHIANG LTD,30-Jun-09,35,0,35
357,GTI2009,SG1Q42922142,L17 ,LION TECK CHIANG LTD,30-Jun-08,33,0,33
162,GTI2013,SG1Q42922142,L18 ,HL GLOBAL ENTERPRISES LIMITED,31-Dec-12,40,3,43
156,GTI2012,SG1Q42922142,L18 ,HL GLOBAL ENTERPRISES LTD,31-Dec-10,40,0,40
325,GTI2011,SG1Q47922220,L18 ,HL GLOBAL ENTERPRISES LIMITED,31-Dec-09,35,-5,30
216,GTI2010,SG1Q47922220,L18 ,HL GLOBAL ENTERPRISES LIMITED,31-Dec-08,36,1,37
70,GTI2009,SG1Q47922220,L18 ,HL GLOBAL ENTERPRISES LIMITED,31-Dec-07,46,-2,44
185,GTI2013,SG1Q48922278,L19 ,LUM CHANG HOLDINGS LIMITED,30-Jun-12,46,-5,41
220,GTI2012,SG1Q48922278,L19 ,LUM CHANG HLDGS LTD,30-Jun-11,42,-5,37
85,GTI2011,SG1Q48922278,L19 ,LUM CHANG HOLDINGS LIMITED,30-Jun-10,44,-1,43
57,GTI2010,SG1Q48922278,L19 ,LUM CHANG HOLDINGS LIMITED,30-Jun-09,46,1,47
97,GTI2009,SG1Q48922278,L19 ,LUM CHANG HOLDINGS LIMITED,30-Jun-08,42,0,42
578,GTI2013,SG1Q49922319,L1D ,CONSCIENCEFOOD HOLDING LIMITED,31-Dec-12,29,-5,24
220,GTI2012,SG1Q49922319,L1D ,CONSCIENCEFOOD HLDG LTD,31-Dec-10,34,3,37
503,GTI2013,SG1Q49922319,L20 ,LIFEBRANDZ LTD.,31-Jul-12,30,-2,28
317,GTI2012,SG1Q49922319,L20 ,LIFEBRANDZ LTD,31-Jul-11,30,3,33
281,GTI2011,SG1Q53922437,L20 ,LIFEBRANDZ LTD.,31-Jul-10,32,0,32
352,GTI2010,SG1Q53922437,L20 ,LIFEBRANDZ LTD.,31-Jul-09,31,1,32
407,GTI2009,SG1Q53922437,L20 ,LIFEBRANDZ LTD.,31-Jul-07,30,1,31
621,GTI2013,SG1Q53922437,L22 ,LANKOM ELECTRONICS LIMITED,31-Dec-11,22,-2,20
666,GTI2012,SG1Q53922437,L22 ,LANKOM ELECTRONICS LTD,31-Dec-10,22,-13,9
544,GTI2011,SG1Q54922550,L22 ,LANKOM ELECTRONICS LIMITED,31-Dec-09,20,0,20
633,GTI2010,SG1Q54922550,L22 ,LANKOM ELECTRONICS LIMITED,31-Dec-08,21,-3,18
634,GTI2009,SG1Q54922550,L22 ,LANKOM ELECTRONICS LIMITED,31-Dec-07,27,-8,19
302,GTI2013,SG1Q54922550,L23 ,ENVIRO-HUB HOLDINGS LTD,31-Dec-12,36,0,36
156,GTI2012,SG1Q54922550,L23 ,ENVIRO-HUB HLDGS LTD,31-Dec-10,43,-3,40
165,GTI2011,SG1Q55922591,L23 ,ENVIRO-HUB HOLDINGS LTD,31-Dec-09,42,-5,37
235,GTI2010,SG1Q55922591,L23 ,ENVIRO-HUB HOLDINGS LTD,31-Dec-08,39,-3,36
111,GTI2009,SG1Q57923167,L23 ,ENVIRO-HUB HOLDINGS LTD,31-Dec-07,44,-3,41
268,GTI2012,SG1Q57923167,L24,LMA INTERNATIONAL N.V.,31-Dec-10,35,0,35
430,GTI2011,SG1Q57923167,L24,LMA INTERNATIONAL N.V.,31-Dec-09,40,-14,26
352,GTI2010,SG1Q57923167,L24,LMA INTERNATIONAL N.V.,31-Dec-08,38,-6,32
140,GTI2009,SG1Q57923167,L24,LMA INTERNATIONAL N.V.,31-Dec-07,46,-6,40
174,GTI2013,SG1Q61923336,L25 ,LEE KIM TAH HLDGS LIMITED,31-Dec-12,41,1,42
500,GTI2012,SG1Q61923336,L25 ,LEE KIM TAH HLDGS LTD,31-Dec-10,31,-5,26
301,GTI2011,SG1Q61923336,L25 ,LEE KIM TAH HLDGS LIMITED,31-Dec-09,36,-5,31
447,GTI2010,SG1Q61923336,L25 ,LEE KIM TAH HLDGS LIMITED,31-Dec-08,34,-5,29
607,GTI2009,SG1Q61923336,L25 ,LEE KIM TAH HLDGS LIMITED,31-Dec-07,30,-8,22
273,GTI2013,SG1Q66923448,L28 ,LONGCHEER HOLDINGS LIMITED,30-Jun-12,37,0,37
242,GTI2012,SG1Q66923448,L28 ,LONGCHEER HLDGS LTD,30-Jun-11,36,0,36
186,GTI2011,SG1Q66923448,L28 ,LONGCHEER HOLDINGS LIMITED,30-Jun-10,36,0,36
129,GTI2010,SG1Q66923448,L28 ,LONGCHEER HOLDINGS LIMITED,30-Jun-09,41,0,41
70,GTI2009,SG1Q66923448,L28 ,LONGCHEER HOLDINGS LIMITED,30-Jun-08,49,-5,44
326,GTI2013,SG1Q67923454,L34 ,LUXKING GROUP HOLDINGS LIMITED,30-Jun-12,37,-2,35
587,GTI2012,SG1Q67923454,L34 ,LUXKING GROUP HLDGS LTD,30-Jun-11,32,-10,22
575,GTI2011,SG1Q67923454,L34 ,LUXKING GROUP HOLDINGS LIMITED,30-Jun-10,29,-12,17
599,GTI2010,SG1Q67923454,L34 ,LUXKING GROUP HOLDINGS LIMITED,30-Jun-09,34,-12,22
654,GTI2009,SG1Q67923454,L34 ,LUXKING GROUP HOLDINGS LIMITED,30-Jun-08,33,-18,15
91,GTI2013,SG1Q73923472,L38 ,L.C.DEVELOPMENT LTD,30-Jun-12,48,3,51
483,GTI2012,SG1Q73923472,L38 ,L.C.DEVELOPMENT LTD,30-Jun-11,35,-8,27
149,GTI2011,SG1Q73923472,L38 ,L.C.DEVELOPMENT LTD,30-Jun-10,46,-8,38
57,GTI2010,SG1Q73923472,L38 ,L.C.DEVELOPMENT LTD,30-Jun-09,46,1,47
196,GTI2009,SG1Q73923472,L38 ,L.C.DEVELOPMENT LTD,30-Jun-08,41,-3,38
74,GTI2013,SG1Q75923504,L46 ,LUZHOU BIO-CHEM TECHNOLOGY LTD,31-Dec-12,51,3,54
105,GTI2012,SG1Q75923504,L46 ,LUZHOU BIO-CHEM TECHNOLOGY LTD,31-Dec-10,41,3,44
66,GTI2011,SG1Q75923504,L46 ,LUZHOU BIO-CHEM TECHNOLOGY LTD,31-Dec-09,46,0,46
129,GTI2010,SG1Q75923504,L46 ,LUZHOU BIO-CHEM TECHNOLOGY LTD,31-Dec-08,38,3,41
330,GTI2009,SG1Q75923504,L46 ,LUZHOU BIO-CHEM TECHNOLOGY LTD,31-Dec-07,31,3,34
108,GTI2013,SG1Q76923560,L5I ,ABTERRA LTD,31-Dec-12,48,1,49
292,GTI2012,SG1Q76923560,L5I ,ABTERRA LTD,31-Dec-10,43,-9,34
254,GTI2011,SG1Q76923560,L5I ,ABTERRA LTD,31-Dec-09,40,-7,33
417,GTI2010,SG1Q76923560,L5I ,ABTERRA LTD,31-Dec-08,32,-2,30
228,GTI2009,SG1Q76923560,L5I ,ABTERRA LTD,30-Jun-08,39,-2,37
503,GTI2013,SG1Q78923675,L5J,VIZ BRANZ LIMITED,30-Jun-12,33,-5,28
455,GTI2012,SG1Q78923675,L5J,VIZ BRANZ LTD,30-Jun-11,33,-5,28
514,GTI2011,SG1Q78923675,L5J,VIZ BRANZ LIMITED,30-Jun-10,27,-5,22
608,GTI2010,SG1Q78923675,L5J,VIZ BRANZ LIMITED,30-Jun-09,26,-5,21
634,GTI2009,SG1Q78923675,L5J,VIZ BRANZ LIMITED,31-Dec-07,24,-5,19
578,GTI2013,SG1Q81923795,L6T ,PSL HOLDINGS LTD,31-Dec-12,32,-8,24
242,GTI2012,SG1Q81923795,L6T ,PSL HLDGS LTD,31-Dec-10,36,0,36
531,GTI2011,SG1Q81923795,L6T ,PSL HOLDINGS LTD,31-Dec-09,23,-2,21
659,GTI2010,SG1Q81923795,L6T ,PSL HOLDINGS LTD,31-Dec-08,19,-7,12
662,GTI2009,SG1Q81923795,L6T ,PSL HOLDINGS LTD,31-Dec-07,22,-10,12
174,GTI2013,SG1Q82923885,LJ3 ,OVERSEAS UNION ENTERPRISE LTD,31-Dec-12,39,3,42
115,GTI2012,SG1Q82923885,LJ3 ,OVERSEAS UNION ENTERPRISE LTD,31-Dec-10,43,0,43
118,GTI2011,SG1Q82923885,LJ3 ,OVERSEAS UNION ENTERPRISE LTD,31-Dec-09,44,-3,41
82,GTI2010,SG1Q82923885,LJ3 ,OVERSEAS UNION ENTERPRISE LTD,31-Dec-08,44,0,44
46,GTI2009,SG1Q82923885,LJ3 ,OVERSEAS UNION ENTERPRISE LTD,31-Dec-07,47,0,47
145,GTI2013,SG1R29924672,LS9 ,LEADER ENVIRONMENTAL TECH LTD,31-Dec-12,42,3,45
115,GTI2012,SG1R29924672,LS9 ,LEADER ENVIRONMENTAL TECHNOLOGIES LTD,31-Dec-10,35,8,43
67,GTI2013,SG1R29924672,M01 ,METRO HOLDINGS LIMITED,31-Mar-12,56,0,56
51,GTI2012,SG1R29924672,M01 ,METRO HLDGS LTD,31-Mar-11,56,-3,53
56,GTI2011,SG1R29924672,M01 ,METRO HOLDINGS LIMITED,31-Mar-10,51,-3,48
33,GTI2010,SG1R31002210,M01 ,METRO HOLDINGS LIMITED,31-Mar-09,52,0,52
292,GTI2009,SG1R31002210,M01 ,METRO HOLDINGS LIMITED,31-Mar-08,44,-9,35
659,GTI2013,SG1R31002210,M03 ,MIYOSHI PRECISION LIMITED,31-Aug-12,32,-25,7
436,GTI2012,SG1R31002210,M03 ,MIYOSHI PRECISION LTD,31-Aug-11,32,-3,29
611,GTI2011,SG1R31002210,M03 ,MIYOSHI PRECISION LIMITED,31-Aug-10,30,-16,14
447,GTI2010,SG1R37924805,M03 ,MIYOSHI PRECISION LIMITED,31-Aug-09,35,-6,29
228,GTI2009,SG1R37924805,M03 ,MIYOSHI PRECISION LIMITED,31-Aug-07,40,-3,37
185,GTI2013,SG1R37924805,M05 ,MTQ CORPORATION LIMITED,31-Mar-12,43,-2,41
220,GTI2012,SG1R37924805,M05 ,MTQ CORP LTD,31-Mar-11,42,-5,37
210,GTI2011,SG1R37924805,M05 ,MTQ CORPORATION LIMITED,31-Mar-10,37,-2,35
82,GTI2010,SG1R38924838,M05 ,MTQ CORPORATION LIMITED,31-Mar-09,46,-2,44
196,GTI2009,SG1R38924838,M05 ,MTQ CORPORATION LIMITED,31-Mar-08,40,-2,38
174,GTI2013,SG1R38924838,M06 ,MULTI-CHEM LIMITED,31-Dec-12,50,-8,42
55,GTI2012,SG1R38924838,M06 ,MULTI-CHEM LTD,31-Dec-10,52,0,52
56,GTI2011,SG1R38924838,M06 ,MULTI-CHEM LIMITED,31-Dec-09,56,-8,48
82,GTI2010,SG1R43925234,M06 ,MULTI-CHEM LIMITED,31-Dec-08,46,-2,44
111,GTI2009,SG1R43925234,M06 ,MULTI-CHEM LIMITED,31-Dec-07,46,-5,41
598,GTI2013,SG1R43925234,M09 ,S I2I LIMITED,30-Jun-12,34,-12,22
292,GTI2012,SG1R43925234,M09 ,S I2I LTD,31-Mar-11,37,-3,34
430,GTI2011,SG1R43925234,M09 ,SPICE I2I LIMITED (FORMERLY MEDIARING LTD),31-Dec-09,42,-16,26
447,GTI2010,SG1R50925390,M09 ,MEDIARING LTD,31-Dec-08,48,-19,29
330,GTI2009,SG1R50925390,M09 ,MEDIARING LTD,31-Dec-07,38,-4,34
480,GTI2013,SG1R50925390,M11 ,MANUFACTURING INTEGRATION TECHNOLOGY LTD,31-Dec-12,37,-8,29
317,GTI2012,SG1R50925390,M11 ,MANUFACTURING INTEGRATION TECHNOLOGY LTD,31-Dec-10,38,-5,33
230,GTI2011,SG1R50925390,M11 ,MFG INTEGRATION TECHNOLOGY LTD,31-Dec-09,42,-8,34
196,GTI2010,SG1R55925478,M11 ,MFG INTEGRATION TECHNOLOGY LTD,31-Dec-08,44,-6,38
97,GTI2009,SG1R55925478,M11 ,MFG INTEGRATION TECHNOLOGY LTD,31-Dec-07,45,-3,42
39,GTI2013,SG1R55925478,M14 ,INNOTEK LIMITED,31-Dec-12,61,6,67
25,GTI2012,SG1R55925478,M14 ,INNOTEK LTD,31-Dec-10,57,12,69
42,GTI2011,SG1R55925478,M14 ,INNOTEK LIMITED,31-Dec-09,55,-4,51
115,GTI2010,SG1R62925800,M14 ,INNOTEK LIMITED,31-Dec-08,44,-2,42
46,GTI2009,SG1R62925800,M14 ,INNOTEK LIMITED,31-Dec-07,46,1,47
630,GTI2013,SG1R62925800,M15 ,MATEX INTERNATIONAL LIMITED,31-Dec-12,39,-20,19
500,GTI2012,SG1R62925800,M15 ,MATEX INTERNATIONAL LTD,31-Dec-10,34,-8,26
301,GTI2011,SG1R62925800,M15 ,MATEX INTERNATIONAL LIMITED,31-Dec-09,42,-11,31
323,GTI2010,SG1R89002252,M15 ,MATEX INTERNATIONAL LIMITED,31-Dec-08,41,-8,33
383,GTI2009,SG1R89002252,M15 ,MATEX INTERNATIONAL LIMITED,31-Dec-07,46,-14,32
273,GTI2013,SG1R89002252,M1P ,AMTEK ENGINEERING LTD,30-Jun-12,36,1,37
379,GTI2012,SG1R89002252,M1P ,AMTEK ENGINEERING LTD,30-Jun-11,36,-5,31
525,GTI2013,SG1R89002252,M1Z ,TEE International Limited,31-May-12,45,-18,27
177,GTI2012,SG1R95002270,M1Z ,TEE INTERNATIONAL LTD,31-May-11,42,-3,39
254,GTI2011,SG1R95002270,M1Z ,TEE INTERNATIONAL LIMITED,31-May-10,41,-8,33
129,GTI2010,SG1R95002270,M1Z ,TEE INTERNATIONAL LIMITED,31-May-09,46,-5,41
357,GTI2009,SG1R95002270,M1Z ,TEE INTERNATIONAL LIMITED,31-May-08,41,-8,33
503,GTI2013,SG1R95002270,M22 ,LOTTVISION LIMITED,31-Mar-12,35,-7,28
410,GTI2012,SG1S02002305,M22 ,LOTTVISION LTD,31-Mar-11,35,-5,30
604,GTI2011,SG1S02002305,M22 ,LOTTVISION LIMITED,31-Mar-10,34,-19,15
447,GTI2010,SG1S02002305,M22 ,LOTTVISION LIMITED,31-Mar-09,43,-14,29
407,GTI2009,SG1S02002305,M22 ,LOTTVISION LIMITED,31-Mar-08,34,-3,31
396,GTI2013,SG1S02002305,M26 ,MEMTECH INTERNATIONAL LTD,31-Dec-12,34,-2,32
379,GTI2012,SG1S04926220,M26 ,MEMTECH INTERNATIONAL LTD,31-Dec-10,36,-5,31
496,GTI2011,SG1S04926220,M26 ,MEMTECH INTERNATIONAL LTD,31-Dec-09,36,-13,23
498,GTI2010,SG1S04926220,M26 ,MEMTECH INTERNATIONAL LTD,31-Dec-08,33,-6,27
383,GTI2009,SG1S04926220,M26 ,MEMTECH INTERNATIONAL LTD,31-Dec-07,38,-6,32
174,GTI2010,SG1S04926220,M30 ,MEGHMANI ORGANICS LIMITED,31-Mar-09,36,3,39
228,GTI2009,SG1S05926369,M30 ,MEGHMANI ORGANICS LIMITED,31-Mar-08,37,0,37
108,GTI2013,SG1S05926369,M35 ,WHEELOCK PROPERTIES (S) LTD,31-Dec-12,43,6,49
242,GTI2012,SG1S05926369,M35 ,WHEELOCK PROPERTIES (S) LTD,31-Dec-10,42,-6,36
149,GTI2011,SG1S05926369,M35 ,WHEELOCK PROPERTIES (S) LTD,31-Dec-09,38,0,38
216,GTI2010,SG1S05926369,M35 ,WHEELOCK PROPERTIES (S) LTD,31-Dec-08,37,0,37
383,GTI2009,SG1S09926464,M35 ,WHEELOCK PROPERTIES (S) LTD,31-Dec-07,35,-3,32
550,GTI2012,SG1S09926464,M8J,CHINA ENVIRONMENTAL RESOURCES GROUP LTD,30-Jun-11,29,-5,24
450,GTI2013,SG1S09926464,M9F ,XMH HOLDINGS LTD,30-Apr-12,46,-16,30
565,GTI2012,SG1S09926464,M9F ,XMH HLDGS LTD,30-Apr-11,33,-10,23
28,GTI2013,SG1S09926464,MC0 ,GLOBAL LOGISTIC PROP LIMITED,31-Mar-12,71,6,77
105,GTI2012,SG1S11926551,MC0 ,GLOBAL LOGISTIC PROPERTIES LTD,31-Mar-11,55,-11,44
373,GTI2013,SG1S11926551,MC7 ,YAMADA GREEN RESOURCES LIMITED,30-Jun-12,38,-5,33
156,GTI2012,SG1S11926551,MC7 ,YAMADA GREEN RESOURCES LTD,31-Dec-10,40,0,40
396,GTI2013,SG1S11926551,MF5 ,ANCHUN INTERNATIONAL HLDGS LTD,31-Dec-12,34,-2,32
355,GTI2012,SG1S11926551,MF5 ,ANCHUN INTERNATIONAL HLDGS LTD,31-Dec-10,32,0,32
49,GTI2013,SG1S12926576,MF6 ,MUN SIONG ENGINEERING LIMITED,31-Dec-12,56,7,63
242,GTI2012,SG1S12926576,MF6 ,MUN SIONG ENGINEERING LTD,31-Dec-10,38,-2,36
174,GTI2013,SG1S12926576,MN5 ,XINREN ALUMINUM HOLDINGS LTD,31-Dec-12,46,-4,42
268,GTI2012,SG1S12926576,MN5 ,XINREN ALUMINUM HLDGS LTD,31-Dec-10,35,0,35
430,GTI2013,SG1S12926576,MQ4 ,BUND CENTER INVESTMENT LTD,31-Dec-12,33,-2,31
355,GTI2012,SG1S15926722,MQ4 ,BUND CENTER INVESTMENT LTD,31-Dec-10,32,0,32
162,GTI2013,SG1S15926722,MR7 ,NORDIC GROUP LIMITED,31-Dec-12,45,-2,43
92,GTI2012,SG1S15926722,MR7 ,NORDIC GROUP LTD,31-Dec-10,44,1,45
353,GTI2013,SG1S15926722,MR8 ,NOVO GROUP LTD.,30-Apr-12,39,-5,34
436,GTI2012,SG1S15926722,MR8 ,NOVO GROUP LTD,30-Apr-11,32,-3,29
458,GTI2011,SG1S28927147,MR8 ,NOVO GROUP LTD. (Formerly Neocorp Intl Ltd),30-Apr-10,37,-12,25
524,GTI2010,SG1S28927147,MR8 ,NOVO GROUP LTD. (Formerly Neocorp Intl Ltd),30-Apr-09,35,-9,26
84,GTI2013,SG1S28927147,MS7 ,VARD HOLDINGS LIMITED (FORMERLY: STX OSV HOLDINGS LIMITED),31-Dec-12,51,1,52
503,GTI2013,SG1S28927147,MT1 ,DRAGON GROUP INTL LIMITED,31-Dec-12,30,-2,28
242,GTI2012,SG1S28927147,MT1 ,DRAGON GROUP INTERNATIONAL LTD,31-Dec-10,39,-3,36
92,GTI2011,SG1S32927257,MT1 ,DRAGON GROUP INTL LIMITED,31-Dec-09,44,-2,42
99,GTI2010,SG1S32927257,MT1 ,DRAGON GROUP INTL LIMITED,31-Dec-08,45,-2,43
61,GTI2009,SG1S32927257,MT1 ,DRAGON GROUP INTL LIMITED,31-Dec-07,47,-2,45
71,GTI2013,SG1S32927257,MV4 ,MEWAH INTERNATIONAL INC,31-Dec-12,51,4,55
92,GTI2012,SG1S32927257,MV4 ,MEWAH INTERNATIONAL INC,31-Dec-10,41,4,45
326,GTI2013,SG1S34927479,N01 ,NERATELECOMMUNICATIONS LTD,31-Dec-12,38,-3,35
92,GTI2012,SG1S34927479,N01 ,NERATELECOMMUNICATIONS LTD,31-Dec-10,45,0,45
325,GTI2011,SG1S34927479,N01 ,NERATELECOMMUNICATIONS LTD,31-Dec-09,41,-11,30
417,GTI2010,SG1S34927479,N01 ,NERATELECOMMUNICATIONS LTD,31-Dec-08,39,-9,30
140,GTI2009,SG1S34927479,N01 ,NERATELECOMMUNICATIONS LTD,31-Dec-07,43,-3,40
302,GTI2013,SG1S35927486,N02 ,NSL LTD.,31-Dec-12,44,-8,36
379,GTI2012,SG1S35927486,N02 ,NSL LTD,31-Dec-10,40,-9,31
186,GTI2011,SG1S35927486,N02 ,NSL LTD.,31-Dec-09,39,-3,36
323,GTI2010,SG1S35927486,N02 ,NSL LTD.,31-Dec-08,33,0,33
505,GTI2009,SG1S35927486,N02 ,NSL LTD. (FORMERLY NATSTEEL LTD),31-Dec-07,33,-6,27
15,GTI2013,SG1S42927578,N03 ,NEPTUNE ORIENT LINES LIMITED,28-Dec-12,71,12,83
81,GTI2012,SG1S42927578,N03 ,NEPTUNE ORIENT LINES LTD,31-Dec-10,45,3,48
28,GTI2011,SG1S42927578,N03 ,NEPTUNE ORIENT LINES LIMITED,25-Dec-09,60,-2,58
48,GTI2010,SG1S42927578,N03 ,NEPTUNE ORIENT LINES LIMITED,26-Dec-08,48,0,48
61,GTI2009,SG1S42927578,N03 ,NEPTUNE ORIENT LINES LIMITED,28-Dec-07,48,-3,45
353,GTI2013,SG1S47927920,N08 ,NEW TOYO INTERNATIONAL HOLDINGS LTD,31-Dec-12,34,0,34
455,GTI2012,SG1S47927920,N08 ,NEW TOYO INTERNATIONAL HLDGS LTD,31-Dec-10,33,-5,28
544,GTI2011,SG1S47927920,N08 ,NEW TOYO INT HLDGS LTD,31-Dec-09,31,-11,20
524,GTI2010,SG1S47927920,N08 ,NEW TOYO INT HLDGS LTD,31-Dec-08,35,-9,26
650,GTI2009,SG1S47927920,N08 ,NEW TOYO INT HLDGS LTD,31-Dec-07,29,-12,17
544,GTI2013,SG1S48927937,N0L ,EASTGATE TECHNOLOGY LTD,31-Aug-12,34,-8,26
641,GTI2012,SG1S48927937,N0L ,EASTGATE TECHNOLOGY LTD,31-Aug-11,19,-2,17
638,GTI2011,SG1S48927937,N0L ,EASTGATE TECHNOLOGY LTD,31-Aug-10,20,-12,8
652,GTI2010,SG1S48927937,N0L ,EASTGATE TECHNOLOGY LTD,31-Aug-09,27,-13,14
529,GTI2009,SG1S48927937,N0L ,EASTGATE TECHNOLOGY LTD,31-Dec-07,26,0,26
162,GTI2013,SG1S49927944,N0Z ,COMBINE WILL INTL HLDGS LTD,31-Dec-12,50,-7,43
292,GTI2012,SG1S49927944,N0Z ,COMBINE WILL INTERNATIONAL HLDGS LTD,31-Dec-10,36,-2,34
92,GTI2011,SG1S49927944,N0Z ,COMBINE WILL INTL HLDGS LTD,31-Dec-09,46,-4,42
216,GTI2010,SG1S49927944,N0Z ,COMBINE WILL INTL HLDGS LTD,31-Dec-08,39,-2,37
330,GTI2009,SG1S49927944,N0Z ,COMBINE WILL INTL HLDGS LTD,31-Dec-07,39,-5,34
598,GTI2013,SG1S61928069,N14 ,M DEVELOPMENT LTD.,31-Dec-12,24,-2,22
292,GTI2012,SG1S61928069,N14 ,M DEVELOPMENT LTD,31-Dec-10,33,1,34
186,GTI2011,SG1S61928069,N14 ,M DEVELOPMENT LTD. (FORMERLY NTI INTERNATIONAL LIMITED),31-Dec-09,30,6,36
633,GTI2010,SG1S61928069,N14 ,NTI INTERNATIONAL LIMITED,31-Dec-08,20,-2,18
629,GTI2009,SG1S61928069,N14 ,NTI INTERNATIONAL LIMITED,31-Dec-07,22,-2,20
503,GTI2013,SG1S69002321,N21 ,NOBLE GROUP LIMITED,31-Dec-12,39,-11,28
92,GTI2012,SG1S69002321,N21 ,NOBLE GROUP LTD,31-Dec-10,53,-8,45
430,GTI2011,SG1S69002321,N21 ,NOBLE GROUP LIMITED,31-Dec-09,49,-23,26
235,GTI2010,SG1S69002321,N21 ,NOBLE GROUP LIMITED,31-Dec-08,42,-6,36
70,GTI2009,SG1S69002321,N21 ,NOBLE GROUP LIMITED,31-Dec-07,44,0,44
430,GTI2013,SG1S70928191,N32 ,NIPPECRAFT LIMITED,31-Dec-12,33,-2,31
533,GTI2012,SG1S70928191,N32 ,NIPPECRAFT LTD,31-Dec-10,28,-3,25
346,GTI2011,SG1S70928191,N32 ,NIPPECRAFT LIMITED,31-Dec-09,32,-3,29
608,GTI2010,SG1S70928191,N32 ,NIPPECRAFT LIMITED,31-Dec-08,24,-3,21
442,GTI2009,SG1S76928401,N32 ,NIPPECRAFT LIMITED,31-Dec-07,33,-3,30
91,GTI2013,SG1S76928401,N4E ,NAM CHEONG LIMITED,31-Dec-12,47,4,51
177,GTI2012,SG1S76928401,N4E ,NAM CHEONG LTD,31-Dec-10,39,0,39
346,GTI2011,SG1S76928401,N4E ,EAGLE BRAND HOLDINGS LTD,31-Dec-09,34,-5,29
564,GTI2010,SG1S76928401,N4E ,EAGLE BRAND HOLDINGS LTD,31-Dec-08,33,-9,24
558,GTI2009,SG1S80928447,N4E ,EAGLE BRAND HOLDINGS LTD,31-Dec-07,38,-13,25
525,GTI2013,SG1S80928447,N6H ,INTERNET TECHNOLOGY GRP LTD,31-Dec-12,32,-5,27
622,GTI2012,SG1S80928447,N6H ,INTERNET TECHNOLOGY GROUP LTD,31-Dec-10,27,-8,19
430,GTI2011,SG1S80928447,N6H ,INTERNET TECHNOLOGY GRP LTD,31-Dec-09,28,-2,26
468,GTI2010,SG1S80928447,N6H ,INTERNET TECHNOLOGY GRP LTD,31-Dec-08,28,0,28
442,GTI2009,SG1S82928544,N6H ,INTERNET TECHNOLOGY GRP LTD,31-Dec-07,35,-5,30
185,GTI2013,SG1S82928544,NC2 ,SRI TRANG AGRO-INDUSTRY PCL,31-Dec-12,40,1,41
207,GTI2013,SG1S82928544,NF1 ,SAPPHIRE CORPORATION LIMITED,31-Dec-12,43,-3,40
500,GTI2012,SG1S82928544,NF1 ,SAPPHIRE CORP LTD,31-Dec-10,32,-6,26
346,GTI2011,SG1S82928544,NF1 ,SAPPHIRE CORPORATION LIMITED,31-Dec-09,32,-3,29
235,GTI2010,SG1S83002349,NF1 ,SAPPHIRE CORPORATION LIMITED,31-Dec-08,44,-8,36
607,GTI2009,SG1S83002349,NF1 ,SAPPHIRE CORPORATION LIMITED,31-Dec-07,33,-11,22
62,GTI2013,SG1S83002349,NI3 ,UE E&C LTD.,31-Dec-12,58,0,58
480,GTI2013,SG1S83002349,NO4 ,DYNA-MAC HOLDINGS LTD.,31-Dec-12,36,-7,29
587,GTI2012,SG1S83002349,NO4 ,DYNA-MAC HLDGS LTD,31-May-11,24,-2,22
207,GTI2013,SG1S90928817,NR7 ,RAFFLES EDUCATION CORP LIMITED,30-Jun-12,43,-3,40
602,GTI2012,SG1S90928817,NR7 ,RAFFLES EDUCATION CORP LTD,30-Jun-11,38,-17,21
479,GTI2011,SG1S90928817,NR7 ,RAFFLES EDUCATION CORP LIMITED,30-Jun-10,41,-17,24
48,GTI2010,SG1S90928817,NR7 ,RAFFLES EDUCATION CORP LIMITED,30-Jun-09,54,-6,48
196,GTI2009,SG1S90928817,NR7 ,RAFFLES EDUCATION CORP LIMITED,30-Jun-08,50,-12,38
639,GTI2013,SG1S94928862,NT1 ,HOTUNG INVESTMENT HLDGS LTD,31-Dec-12,23,-5,18
602,GTI2012,SG1S94928862,NT1 ,HOTUNG INVESTMENT HLDGS LTD,31-Dec-10,21,0,21
588,GTI2011,SG1S94928862,NT1 ,HOTUNG INVESTMENT HLDGS LTD,31-Dec-09,24,-8,16
468,GTI2010,SG1S94928862,NT1 ,HOTUNG INVESTMENT HLDGS LTD,31-Dec-08,27,1,28
463,GTI2009,SG1S94928862,NT1 ,HOTUNG INVESTMENT HLDGS LTD,31-Dec-07,34,-5,29
302,GTI2013,SG1S95928879,O05 ,OCEAN SKY INTERNATIONAL LTD,31-Dec-12,42,-6,36
177,GTI2012,SG1S95928879,O05 ,OCEAN SKY INTERNATIONAL LTD,31-Dec-10,42,-3,39
496,GTI2011,SG1S95928879,O05 ,OCEAN SKY INTERNATIONAL LTD,31-Dec-09,39,-16,23
524,GTI2010,SG1S95928879,O05 ,OCEAN SKY INTERNATIONAL LTD,31-Dec-08,32,-6,26
383,GTI2009,SG1S95928879,O05 ,OCEAN SKY INTERNATIONAL LTD,31-Dec-07,38,-6,32
525,GTI2013,SG1T03928994,O08 ,OSSIA INTERNATIONAL LTD,31-Dec-11,34,-7,27
436,GTI2012,SG1T03928994,O08 ,OSSIA INTERNATIONAL LTD,31-Dec-10,31,-2,29
254,GTI2011,SG1T03928994,O08 ,OSSIA INTERNATIONAL LTD,31-Dec-09,40,-7,33
296,GTI2010,SG1T03928994,O08 ,OSSIA INTERNATIONAL LTD,31-Dec-08,34,0,34
266,GTI2009,SG1T03928994,O08 ,OSSIA INTERNATIONAL LTD,31-Dec-07,39,-3,36
302,GTI2013,SG1T05929172,O10 ,FAR EAST ORCHARD LIMITED,31-Dec-12,39,-3,36
565,GTI2012,SG1T05929172,O10 ,ORCHARD PARADE HLDGS LTD,31-Dec-10,26,-3,23
377,GTI2011,SG1T05929172,O10 ,ORCHARD PARADE HOLDINGS LTD,31-Dec-09,31,-3,28
586,GTI2010,SG1T05929172,O10 ,ORCHARD PARADE HOLDINGS LTD,31-Dec-08,29,-6,23
505,GTI2009,SG1T06929205,O10 ,ORCHARD PARADE HOLDINGS LTD,31-Dec-07,30,-3,27
273,GTI2013,SG1T06929205,O23 ,OSIM INTERNATIONAL LTD,31-Dec-12,44,-7,37
82,GTI2012,SG1T06929205,O23 ,OSIM INTERNATIONAL LTD,31-Dec-10,49,-2,47
72,GTI2011,SG1T06929205,O23 ,OSIM INTERNATIONAL LTD,31-Dec-09,52,-7,45
43,GTI2010,SG1T06929205,O23 ,OSIM INTERNATIONAL LTD,31-Dec-08,54,-5,49
26,GTI2009,SG1T17929525,O23 ,OSIM INTERNATIONAL LTD,31-Dec-07,57,-5,52
430,GTI2013,SG1T17929525,O2F ,SWING MEDIA TECHNOLOGY GROUP LTD,31-Mar-12,37,-6,31
500,GTI2012,SG1T17929525,O2F ,SWING MEDIA TECHNOLOGY GROUP LTD,31-Mar-11,35,-9,26
430,GTI2011,SG1T17929525,O2F ,SWING MEDIA TECHNOLOGY GRP LTD,31-Mar-10,37,-11,26
524,GTI2010,SG1T17929525,O2F ,SWING MEDIA TECHNOLOGY GRP LTD,31-Mar-09,43,-17,26
166,GTI2009,SG1T19929580,O2F ,SWING MEDIA TECHNOLOGY GRP LTD,31-Mar-08,48,-9,39
396,GTI2013,SG1T19929580,O2I ,AVIC INTL INVESTMENTS LIMITED,31-Dec-12,36,-4,32
621,GTI2013,SG1T19929580,O2R ,CHINASING INVESTMENT HLDG LTD,31-Dec-12,22,-2,20
670,GTI2012,SG1T19929580,O2R ,CHINASING INVESTMENT HLDGS LTD,31-Dec-10,23,-16,7
653,GTI2011,SG1T19929580,O2R ,CHINASING INVESTMENT HLDG LTD,31-Dec-09,18,-20,-2
665,GTI2009,SG1T20929850,O2R ,CHINASING INVESTMENT HLDG LTD,30-Jun-08,29,-18,11
41,GTI2013,SG1T20929850,O32 ,OLAM INTERNATIONAL LIMITED,30-Jun-12,71,-6,65
43,GTI2012,SG1T20929850,O32 ,OLAM INTERNATIONAL LTD,30-Jun-11,55,0,55
26,GTI2011,SG1T20929850,O32 ,OLAM INTERNATIONAL LIMITED,30-Jun-10,59,0,59
21,GTI2010,SG1T20929850,O32 ,OLAM INTERNATIONAL LIMITED,30-Jun-09,61,-3,58
140,GTI2009,SG1T21929867,O32 ,OLAM INTERNATIONAL LIMITED,30-Jun-08,50,-10,40
21,GTI2013,SG1T21929867,O39 ,OVERSEA-CHINESE BANKING CORP,31-Dec-12,69,12,81
21,GTI2012,SG1T21929867,O39 ,OVERSEA-CHINESE BANKING CORP LTD,31-Dec-10,70,3,73
20,GTI2011,SG1T21929867,O39 ,OVERSEA-CHINESE BANKING CORP,31-Dec-09,70,-2,68
16,GTI2010,SG1T21929867,O39 ,OVERSEA-CHINESE BANKING CORP,31-Dec-08,65,0,65
33,GTI2009,SG1T28930090,O39 ,OVERSEA-CHINESE BANKING CORP,31-Dec-07,55,-4,51
643,GTI2013,SG1T28930090,OJ4,CONTEL CORPORATION LIMITED,31-Mar-12,32,-15,17
317,GTI2012,SG1T28930090,OJ4,CONTEL CORP LTD,31-Mar-11,36,-3,33
377,GTI2011,SG1T28930090,OJ4,CONTEL CORPORATION LIMITED,31-Mar-10,37,-9,28
235,GTI2010,SG1T28930090,OJ4,CONTEL CORPORATION LIMITED,31-Mar-09,38,-2,36
292,GTI2009,SG1T29930156,OJ4,CONTEL CORPORATION LIMITED,31-Mar-08,35,0,35
273,GTI2013,SG1T29930156,ON7 ,WEIYE HOLDINGS LIMITED,31-Dec-12,42,-5,37
659,GTI2012,SG1T29930156,ON7 ,WEIYE HLDGS LTD,30-Jun-10,16,-3,13
575,GTI2011,SG1T29930156,ON7 ,KYODO-ALLIED INDUSTRIES LTD,30-Jun-10,20,-3,17
608,GTI2010,SG1T29930156,ON7 ,KYODO-ALLIED INDUSTRIES LTD,30-Jun-09,21,0,21
558,GTI2009,SG1T35930281,ON7 ,KYODO-ALLIED INDUSTRIES LTD,30-Jun-08,28,-3,25
450,GTI2013,SG1T35930281,OU8 ,CENTURION CORPORATION LIMITED,31-Dec-12,30,0,30
500,GTI2012,SG1T35930281,OU8 ,CENTURION CORP LTD,31-Dec-10,28,-2,26
281,GTI2011,SG1T35930281,OU8 ,SM SUMMIT HOLDINGS LTD,31-Dec-09,32,0,32
216,GTI2010,SG1T35930281,OU8 ,SM SUMMIT HOLDINGS LTD,31-Dec-08,37,0,37
166,GTI2009,SG1T36930298,OU8 ,SM SUMMIT HOLDINGS LTD,31-Dec-07,41,-2,39
67,GTI2013,SG1T36930298,OV8 ,SHENG SIONG GROUP LTD,31-Dec-12,53,3,56
578,GTI2013,SG1T36930298,P01 ,POH TIONG CHOON LOGISTICS LTD,31-Dec-12,27,-3,24
652,GTI2012,SG1T36930298,P01 ,POH TIONG CHOON LOGISTICS LTD,31-Dec-10,26,-11,15
575,GTI2011,SG1T36930298,P01 ,POH TIONG CHOON LOGISTICS LTD,31-Dec-09,25,-8,17
664,GTI2010,SG1T37930313,P01 ,POH TIONG CHOON LOGISTICS LTD,31-Dec-08,20,-10,10
662,GTI2009,SG1T37930313,P01 ,POH TIONG CHOON LOGISTICS LTD,31-Dec-07,25,-13,12
430,GTI2013,SG1T37930313,P05,PEOPLE'S FOOD HOLDINGS LIMITED,31-Dec-12,42,-11,31
500,GTI2012,SG1T37930313,P05,PEOPLE'S FOOD HLDGS LTD,31-Dec-10,39,-13,26
544,GTI2011,SG1T37930313,P05,PEOPLE'S FOOD HOLDINGS LIMITED,31-Dec-09,35,-15,20
648,GTI2010,SG1T38930320,P05,PEOPLE'S FOOD HOLDINGS LIMITED,31-Dec-08,27,-12,15
644,GTI2009,SG1T38930320,P05,PEOPLE'S FOOD HOLDINGS LIMITED,31-Dec-07,33,-15,18
273,GTI2013,SG1T38930320,P06,PCA TECHNOLOGY LIMITED,28-Feb-12,36,1,37
156,GTI2012,SG1T38930320,P06,PCA TECHNOLOGY LTD,28-Feb-11,37,3,40
186,GTI2011,SG1T38930320,P06,PCA TECHNOLOGY LIMITED,28-Feb-10,36,0,36
395,GTI2010,SG1T49930665,P06,PCA TECHNOLOGY LIMITED,28-Feb-09,37,-6,31
82,GTI2009,SG1T49930665,P06,PCA TECHNOLOGY LIMITED,28-Feb-08,45,-2,43
588,GTI2013,SG1T49930665,P07 ,PNE INDUSTRIES LTD,30-Sep-12,25,-2,23
587,GTI2012,SG1T49930665,P07 ,PNE INDUSTRIES LTD,30-Sep-11,27,-5,22
567,GTI2011,SG1T49930665,P07 ,PNE INDUSTRIES LTD,30-Sep-10,24,-6,18
628,GTI2010,SG1T56930848,P07 ,PNE INDUSTRIES LTD,30-Sep-08,22,-3,19
634,GTI2009,SG1T56930848,P07 ,PNE INDUSTRIES LTD,30-Sep-07,24,-5,19
230,GTI2013,SG1T56930848,P11 ,PACIFIC ANDES RESOURCES DEVLTD,28-Sep-12,42,-3,39
196,GTI2012,SG1T56930848,P11 ,PACIFIC ANDES RESOURCES DEVLTD,28-Sep-11,40,-2,38
149,GTI2011,SG1T56930848,P11 ,PACIFIC ANDES RESOURCES DEVELOPMENT LTD (FORMERLY PACIFIC ANDES (HOLDINGS) LTD),28-Sep-10,44,-6,38
196,GTI2010,SG1T57930854,P11 ,PACIFIC ANDES RESOURCES DEVELOPMENT LTD (FORMERLY PACIFIC ANDES (HOLDINGS) LTD),31-Mar-09,44,-6,38
634,GTI2009,SG1T57930854,P11 ,PACIFIC ANDES (HOLDINGS) LTD,31-Mar-08,27,-8,19
566,GTI2013,SG1T57930854,P12 ,POWERMATIC DATA SYSTEMS LTD,31-Mar-12,36,-11,25
220,GTI2012,SG1T57930854,P12 ,POWERMATIC DATA SYSTEMS LTD,31-Mar-11,39,-2,37
458,GTI2011,SG1T57930854,P12 ,POWERMATIC DATA SYSTEMS LTD,31-Mar-10,32,-7,25
417,GTI2010,SG1T58930911,P12 ,POWERMATIC DATA SYSTEMS LTD,31-Mar-09,35,-5,30
485,GTI2009,SG1T58930911,P12 ,POWERMATIC DATA SYSTEMS LTD,31-Mar-08,36,-8,28
154,GTI2013,SG1T58930911,P13 ,PENGUIN INTERNATIONAL LIMITED,31-Dec-12,41,3,44
242,GTI2012,SG1T58930911,P13 ,PENGUIN INTERNATIONAL LTD,31-Dec-10,36,0,36
165,GTI2011,SG1T64931051,P13 ,PENGUIN INTERNATIONAL LIMITED,31-Dec-09,42,-5,37
323,GTI2010,SG1T64931051,P13 ,PENGUIN INTERNATIONAL LIMITED,31-Dec-08,38,-5,33
357,GTI2009,SG1T64931051,P13 ,PENGUIN INTERNATIONAL LIMITED,31-Dec-07,41,-8,33
252,GTI2013,SG1T64931051,P15 ,PACIFIC CENTURY REGIONAL DEVELOPMENTS LTD,31-Dec-12,43,-5,38
641,GTI2012,SG1T64931051,P15 ,PACIFIC CENTURY REGIONAL DEVELOPMENTS LTD,31-Dec-10,30,-13,17
629,GTI2011,SG1T74931364,P15 ,PACIFIC CENTURY REGIONAL DEVTS,31-Dec-09,32,-21,11
664,GTI2010,SG1T74931364,P15 ,PACIFIC CENTURY REGIONAL DEVTS,31-Dec-08,31,-21,10
668,GTI2009,SG1T74931364,P15 ,PACIFIC CENTURY REGIONAL DEVTS,31-Dec-07,31,-21,10
353,GTI2013,SG1T74931364,P19 ,PCI LTD,30-Jun-12,34,0,34
410,GTI2012,SG1T74931364,P19 ,PCI LTD,30-Jun-11,33,-3,30
186,GTI2011,SG1T75931496,P19 ,PCI LTD,30-Jun-10,36,0,36
148,GTI2010,SG1T75931496,P19 ,PCI LTD,30-Jun-09,40,0,40
111,GTI2009,SG1T75931496,P19 ,PCI LTD,30-Jun-08,43,-2,41
557,GTI2011,SG1T75931496,P22 ,PERTAMA HOLDINGS LIMITED,30-Jun-10,26,-7,19
543,GTI2010,SG1T75931496,P22 ,PERTAMA HOLDINGS LIMITED,30-Jun-09,27,-2,25
558,GTI2009,SG1T88932077,P22 ,PERTAMA HOLDINGS LIMITED,30-Jun-08,33,-8,25
207,GTI2013,SG1T88932077,P29 ,POPULAR HOLDINGS LIMITED,30-Apr-12,39,1,40
317,GTI2012,SG1T88932077,P29 ,POPULAR HLDGS LTD,30-Apr-11,33,0,33
118,GTI2011,SG1T88932077,P29 ,POPULAR HOLDINGS LIMITED,30-Apr-10,41,0,41
447,GTI2010,SG1T88932077,P29 ,POPULAR HOLDINGS LIMITED,30-Apr-09,37,-8,29
407,GTI2009,SG1U08932378,P29 ,POPULAR HOLDINGS LIMITED,30-Apr-08,36,-5,31
396,GTI2013,SG1U08932378,P30 ,UNITED FIBER SYSTEM LIMITED,31-Dec-12,37,-5,32
242,GTI2012,SG1U08932378,P30 ,UNITED FIBER SYSTEM LTD,31-Dec-10,36,0,36
407,GTI2011,SG1U08932378,P30 ,UNITED FIBER SYSTEM LIMITED,31-Dec-09,36,-9,27
216,GTI2010,SG1U08932378,P30 ,UNITED FIBER SYSTEM LIMITED,31-Dec-08,39,-2,37
111,GTI2009,SG1U10932531,P30 ,UNITED FIBER SYSTEM LIMITED,31-Dec-07,41,0,41
185,GTI2013,SG1U10932531,P31 ,PHARMESIS INTERNATIONAL LTD,31-Dec-12,47,-6,41
242,GTI2012,SG1U10932531,P31 ,PHARMESIS INTERNATIONAL LTD,31-Dec-10,42,-6,36
210,GTI2011,SG1U10932531,P31 ,PHARMESIS INTERNATIONAL LTD.,31-Dec-09,41,-6,35
115,GTI2010,SG1U10932531,P31 ,PHARMESIS INTERNATIONAL LTD.,31-Dec-08,45,-3,42
196,GTI2009,SG1U11932563,P31 ,PHARMESIS INTERNATIONAL LTD.,31-Dec-07,46,-8,38
40,GTI2013,SG1U11932563,P34 ,PETRA FOODS LIMITED,31-Dec-12,63,3,66
51,GTI2012,SG1U11932563,P34 ,PETRA FOODS LTD,31-Dec-10,56,-3,53
66,GTI2011,SG1U11932563,P34 ,PETRA FOODS LIMITED,31-Dec-09,50,-4,46
33,GTI2010,SG1U13932587,P34 ,PETRA FOODS LIMITED,31-Dec-08,54,-2,52
15,GTI2009,SG1U13932587,P34 ,PETRA FOODS LIMITED,31-Dec-07,57,-2,55
252,GTI2013,SG1U13932587,P36 ,PAN HONG PROPERTY GROUP LTD,31-Mar-12,38,0,38
131,GTI2012,SG1U13932587,P36 ,PAN HONG PROPERTY GROUP LTD,31-Mar-11,45,-3,42
92,GTI2011,SG1U13932587,P36 ,PAN HONG PROPERTY GROUP LTD,31-Mar-10,44,-2,42
196,GTI2010,SG1U22933048,P36 ,PAN HONG PROPERTY GROUP LTD,31-Mar-09,38,0,38
46,GTI2009,SG1U22933048,P36 ,PAN HONG PROPERTY GROUP LTD,31-Dec-07,44,3,47
662,GTI2013,SG1U22933048,P47 ,PACIFIC HEALTHCARE HOLDINGS LTD.,31-Dec-12,38,-41,-3
662,GTI2012,SG1U22933048,P47 ,PACIFIC HEALTHCARE HLDGS LTD,31-Dec-10,29,-17,12
479,GTI2011,SG1U22933048,P47 ,PACIFIC HEALTHCARE HLDGS LTD,31-Dec-09,29,-5,24
267,GTI2010,SG1U32933335,P47 ,PACIFIC HEALTHCARE HLDGS LTD,31-Dec-08,40,-5,35
40,GTI2009,SG1U32933335,P47 ,PACIFIC HEALTHCARE HLDGS LTD,31-Dec-07,50,-2,48
162,GTI2013,SG1U32933335,P52 ,PAN-UNITED CORPORATION LTD,31-Dec-12,49,-6,43
220,GTI2012,SG1U32933335,P52 ,PAN-UNITED CORP LTD,31-Dec-10,46,-9,37
301,GTI2011,SG1U32933335,P52 ,PAN-UNITED CORPORATION LTD,31-Dec-09,40,-9,31
447,GTI2010,SG1U37933462,P52 ,PAN-UNITED CORPORATION LTD,31-Dec-08,49,-20,29
485,GTI2009,SG1U37933462,P52 ,PAN-UNITED CORPORATION LTD,31-Dec-07,43,-15,28
273,GTI2013,SG1U37933462,P74 ,CHINA KANGDA FOOD COMPANY LTD,31-Dec-12,39,-2,37
379,GTI2012,SG1U37933462,P74 ,CHINA KANGDA FOOD COMPANY LTD,31-Dec-10,31,0,31
140,GTI2011,SG1U37933462,P74 ,CHINA KANGDA FOOD COMPANY LTD,31-Dec-09,41,-2,39
352,GTI2010,SG1U46933891,P74 ,CHINA KANGDA FOOD COMPANY LTD,31-Dec-08,32,0,32
292,GTI2009,SG1U46933891,P74 ,CHINA KANGDA FOOD COMPANY LTD,31-Dec-07,35,0,35
525,GTI2013,SG1U46933891,P82 ,PLASTOFORM HOLDINGS LIMITED,31-Dec-12,27,0,27
587,GTI2012,SG1U46933891,P82 ,PLASTOFORM HLDGS LTD,31-Dec-10,24,-2,22
604,GTI2011,SG1U46933891,P82 ,PLASTOFORM HOLDINGS LIMITED,31-Dec-09,22,-7,15
620,GTI2010,SG1U47933908,P82 ,PLASTOFORM HOLDINGS LIMITED,31-Dec-08,25,-5,20
145,GTI2013,SG1U47933908,PA3 ,TA CORPORATION LTD,31-Dec-12,42,3,45
525,GTI2013,SG1U47933908,PH0 ,VGO CORPORATION LIMITED,31-Dec-12,35,-8,27
455,GTI2012,SG1U47933908,PH0 ,VGO CORP LTD,31-Dec-10,30,-2,28
407,GTI2011,SG1U47933908,PH0 ,VGO CORPORATION LIMITED,31-Dec-09,32,-5,27
352,GTI2010,SG1U49933948,PH0 ,VGO CORPORATION LIMITED,31-Dec-08,32,0,32
558,GTI2009,SG1U49933948,PH0 ,VGO CORPORATION LIMITED,31-Dec-07,28,-3,25
207,GTI2013,SG1U49933948,Q01 ,QAF LTD,31-Dec-12,46,-6,40
268,GTI2012,SG1U49933948,Q01 ,QAF LTD,31-Dec-10,41,-6,35
149,GTI2011,SG1U49933948,Q01 ,QAF LTD,31-Dec-09,44,-6,38
196,GTI2010,SG1U51934008,Q01 ,QAF LTD,31-Dec-08,38,0,38
330,GTI2009,SG1U51934008,Q01 ,QAF LTD,31-Dec-07,40,-6,34
102,GTI2013,SG1U51934008,Q0X ,LEY CHOON GROUP HOLDINGS LIMITED,31-Dec-12,49,1,50
533,GTI2012,SG1U51934008,Q0X ,ULTRO TECHNOLOGIES LTD,30-Jun-11,27,-2,25
450,GTI2013,SG1U56934110,Q7Q ,SURFACE MOUNT TECHNOLOGY (HOLDINGS) LTD,31-Mar-12,39,-9,30
455,GTI2012,SG1U56934110,Q7Q ,SURFACE MOUNT TECH (HLDGS) LTD,31-Mar-11,37,-9,28
621,GTI2013,SG1U56934110,Q7W ,LANTROVISION (S) LTD,30-Jun-12,24,-4,20
587,GTI2012,SG1U56934110,Q7W ,LANTROVISION (S) LTD,30-Jun-11,24,-2,22
567,GTI2011,SG1U68934629,Q7W ,LANTROVISION (S) LTD,30-Jun-10,22,-4,18
543,GTI2010,SG1U68934629,Q7W ,LANTROVISION (S) LTD,30-Jun-09,25,0,25
558,GTI2009,SG1U68934629,Q7W ,LANTROVISION (S) LTD,30-Jun-08,27,-2,25
326,GTI2013,SG1U68934629,QC7 ,Q & M DENTAL GROUP (S) LIMITED,31-Dec-12,36,-1,35
379,GTI2012,SG1U68934629,QC7 ,Q & M DENTAL GROUP (S) LTD,31-Dec-10,33,-2,31
185,GTI2013,SG1U69934651,QG1 ,METECH INTERNATIONAL LIMITED,30-Jun-12,41,0,41
355,GTI2012,SG1U69934651,QG1 ,CENTILLION ENVIRONMENT & RECYCLING LTD,30-Jun-11,32,0,32
118,GTI2011,SG1U69934651,QG1 ,CENTILLION ENV & RECYC LIMITED,30-Jun-10,38,3,41
57,GTI2010,SG1U69934651,QG1 ,CENTILLION ENV & RECYC LIMITED,30-Jun-09,47,0,47
196,GTI2009,SG1U76934819,QG1 ,CENTILLION ENV & RECYC LIMITED,30-Jun-08,41,-3,38
207,GTI2013,SG1U76934819,QS9 ,GLOBAL INVACOM GROUP LIMITED,31-Dec-12,42,-2,40
379,GTI2012,SG1U76934819,QS9 ,RADIANCE GROUP LTD,31-Dec-10,31,0,31
479,GTI2011,SG1U76934819,QS9 ,RADIANCE GROUP LIMITED,31-Dec-09,23,1,24
447,GTI2010,SG1U76934819,QS9 ,RADIANCE GROUP LIMITED,31-Dec-08,31,-2,29
196,GTI2009,SG1U86935475,QS9 ,RADIANCE ELECTRONICS LIMITED,30-Jun-08,40,-2,38
326,GTI2013,SG1U86935475,R01 ,RAFFLES MEDICAL GROUP LTD,31-Dec-12,38,-3,35
565,GTI2012,SG1U86935475,R01 ,RAFFLES MEDICAL GROUP LTD,31-Dec-10,31,-8,23
496,GTI2011,SG1U86935475,R01 ,RAFFLES MEDICAL GROUP LTD,31-Dec-09,35,-12,23
395,GTI2010,SG1U86935475,R01 ,RAFFLES MEDICAL GROUP LTD,31-Dec-08,34,-3,31
615,GTI2009,SG1U88935523,R01 ,RAFFLES MEDICAL GROUP LTD,31-Dec-07,28,-7,21
230,GTI2013,SG1U89935555,R07 ,ROTARY ENGINEERING LIMITED,31-Dec-12,47,-8,39
242,GTI2012,SG1U89935555,R07 ,ROTARY ENGINEERING LTD,31-Dec-10,44,-8,36
531,GTI2011,SG1U89935555,R07 ,ROTARY ENGINEERING LIMITED,31-Dec-09,35,-14,21
564,GTI2010,SG1U89935555,R07 ,ROTARY ENGINEERING LIMITED,31-Dec-08,35,-11,24
591,GTI2009,SG1U89935555,R07 ,ROTARY ENGINEERING LIMITED,31-Dec-07,34,-11,23
396,GTI2013,SG1U95935722,R14 ,RAMBA ENERGY LIMITED,31-Dec-12,39,-7,32
500,GTI2012,SG1U95935722,R14 ,RAMBA ENERGY LTD,31-Dec-10,35,-9,26
496,GTI2011,SG1U95935722,R14 ,RAMBA ENERGY LIMITED,31-Dec-09,37,-14,23
296,GTI2010,SG1U95935722,R14 ,RAMBA ENERGY LIMITED,31-Dec-08,51,-17,34
383,GTI2009,SG1U95935722,R14 ,RICHLAND GROUP LIMITED,31-Dec-07,43,-11,32
430,GTI2013,SG1U97935860,S05 ,SIM LIAN GROUP LIMITED,30-Jun-12,36,-5,31
379,GTI2012,SG1U97935860,S05 ,SIM LIAN GROUP LTD,30-Jun-11,34,-3,31
325,GTI2011,SG1U97935860,S05 ,SIM LIAN GROUP LIMITED,30-Jun-10,35,-5,30
417,GTI2010,SG1U97935860,S05 ,SIM LIAN GROUP LIMITED,30-Jun-09,35,-5,30
529,GTI2009,SG1U97935860,S05 ,SIM LIAN GROUP LIMITED,30-Jun-08,34,-8,26
31,GTI2013,SG1V04936067,S08 ,SINGAPORE POST LIMITED,31-Mar-12,70,3,73
24,GTI2012,SG1V04936067,S08 ,SINGAPORE POST LTD,31-Mar-11,64,6,70
17,GTI2011,SG1V04936067,S08 ,SINGAPORE POST LIMITED,31-Mar-10,75,-5,70
7,GTI2010,SG1V04936067,S08 ,SINGAPORE POST LIMITED,31-Mar-09,72,3,75
8,GTI2009,SG1V04936067,S08 ,SINGAPORE POST LIMITED,31-Mar-08,69,-3,66
122,GTI2013,SG1V05936116,S10 ,SUPER GROUP LTD.,31-Dec-12,50,-3,47
379,GTI2012,SG1V05936116,S10 ,SUPER GROUP LTD,31-Dec-10,40,-9,31
514,GTI2011,SG1V05936116,S10 ,SUPER GROUP LTD (FORMERLY SUPER COFFEEMIX MANUFACTURING),31-Dec-09,36,-14,22
543,GTI2010,SG1V05936116,S10 ,SUPER COFFEEMIX MANUFACTURING,31-Dec-08,34,-9,25
463,GTI2009,SG1V05936116,S10 ,SUPER COFFEEMIX MANUFACTURING,31-Dec-07,35,-6,29
77,GTI2013,SG1V07936171,S13 ,SP CORPORATION LIMITED,31-Dec-12,47,6,53
46,GTI2012,SG1V07936171,S13 ,SP CORP LTD,31-Dec-10,45,9,54
40,GTI2011,SG1V07936171,S13 ,SP CORPORATION LIMITED,31-Dec-09,46,6,52
43,GTI2010,SG1V07936171,S13 ,SP CORPORATION LIMITED,31-Dec-08,43,6,49
53,GTI2009,SG1V07936171,S13 ,SP CORPORATION LIMITED,31-Dec-07,45,1,46
373,GTI2013,SG1V08936188,S19 ,SINGAPORE SHIPPING CORPORATION LTD,31-Mar-12,35,-2,33
220,GTI2012,SG1V08936188,S19 ,SINGAPORE SHIPPING CORP LTD,31-Mar-11,42,-5,37
458,GTI2011,SG1V08936188,S19 ,SINGAPORE SHIPPING CORP LTD,31-Mar-10,30,-5,25
148,GTI2010,SG1V08936188,S19 ,SINGAPORE SHIPPING CORP LTD,31-Mar-09,40,0,40
82,GTI2009,SG1V08936188,S19 ,SINGAPORE SHIPPING CORP LTD,31-Mar-08,46,-3,43
326,GTI2013,SG1V12936232,S20 ,STRAITS TRADING CO. LTD,31-Dec-12,41,-6,35
436,GTI2012,SG1V12936232,S20 ,STRAITS TRADING COMPANY LTD,31-Dec-10,41,-12,29
140,GTI2011,SG1V12936232,S20 ,STRAITS TRADING CO. LTD,31-Dec-09,39,0,39
352,GTI2010,SG1V12936232,S20 ,STRAITS TRADING CO. LTD,31-Dec-08,38,-6,32
37,GTI2009,SG1V12936232,S20 ,STRAITS TRADING CO. LTD,31-Dec-07,50,0,50
162,GTI2013,SG1V17936401,S23 ,SINGAPURA FINANCE LTD,30-Jun-12,45,-2,43
115,GTI2012,SG1V17936401,S23 ,SINGAPURA FINANCE LTD,30-Jun-11,43,0,43
281,GTI2011,SG1V17936401,S23 ,SINGAPURA FINANCE LTD,30-Jun-10,37,-5,32
148,GTI2010,SG1V17936401,S23 ,SINGAPURA FINANCE LTD,30-Jun-09,39,1,40
485,GTI2009,SG1V17936401,S23 ,SINGAPURA FINANCE LTD,30-Jun-08,33,-5,28
84,GTI2013,SG1V17936401,S24 ,STATS CHIPPAC LTD,31-Dec-12,58,-6,52
61,GTI2012,SG1V20936588,S24 ,STATS CHIPPAC LTD,26-Dec-10,52,-1,51
230,GTI2013,SG1V20936588,S29 ,STAMFORD TYRES CORPORATION LTD,30-Apr-12,44,-5,39
317,GTI2012,SG1V20936588,S29 ,STAMFORD TYRES CORPLTD,30-Apr-11,44,-11,33
301,GTI2011,SG1V20936588,S29 ,STAMFORD TYRES CORPORATIONLTD,30-Apr-10,39,-8,31
323,GTI2010,SG1V20936588,S29 ,STAMFORD TYRES CORPORATIONLTD,30-Apr-09,36,-3,33
503,GTI2013,SG1V30936768,S30 ,SINGAPORE LAND LIMITED,31-Dec-12,34,-6,28
611,GTI2012,SG1V30936768,S30 ,SINGAPORE LAND LTD,31-Dec-10,31,-11,20
407,GTI2011,SG1V30936768,S30 ,SINGAPORE LAND LIMITED,31-Dec-09,30,-3,27
468,GTI2010,SG1V30936768,S30 ,SINGAPORE LAND LIMITED,31-Dec-08,31,-3,28
292,GTI2009,SG1V30936768,S30 ,SINGAPORE LAND LIMITED,31-Dec-07,38,-3,35
46,GTI2013,SG1V34936913,S35 ,SING INVESTMENTS & FINANCE LTD,31-Dec-12,54,10,64
82,GTI2012,SG1V34936913,S35 ,SING INVESTMENTS & FINANCE LTD,31-Dec-10,47,0,47
377,GTI2011,SG1V34936913,S35 ,SING INVESTMENTS & FINANCE LTD,31-Dec-09,39,-11,28
296,GTI2010,SG1V34936913,S35 ,SING INVESTMENTS & FINANCE LTD,31-Dec-08,31,3,34
330,GTI2009,SG1V34936913,S35 ,SING INVESTMENTS & FINANCE LTD,31-Dec-07,31,3,34
598,GTI2013,SG1V36936952,S38 ,SUNRAY HOLDINGS LIMITED,31-Mar-12,31,-9,22
671,GTI2012,SG1V36936952,S38 ,SUNRAY HLDGS LTD,31-Mar-11,22,-16,6
629,GTI2011,SG1V36936952,S38 ,SUNRAY HOLDINGS LIMITED,31-Mar-10,32,-21,11
628,GTI2010,SG1V36936952,S38 ,SUNRAY HOLDINGS LIMITED,31-Mar-09,37,-18,19
659,GTI2009,SG1V36936952,S38 ,SUNRAY HOLDINGS LIMITED,31-Mar-08,35,-21,14
29,GTI2013,SG1V37936969,S41 ,HONG LEONG FINANCE LIMITED,31-Dec-12,56,18,74
37,GTI2012,SG1V37936969,S41 ,HONG LEONG FINANCE LTD,31-Dec-10,57,3,60
34,GTI2011,SG1V37936969,S41 ,HONG LEONG FINANCE LIMITED,31-Dec-09,55,0,55
29,GTI2010,SG1V37936969,S41 ,HONG LEONG FINANCE LIMITED,31-Dec-08,52,3,55
53,GTI2009,SG1V37936969,S41 ,HONG LEONG FINANCE LIMITED,31-Dec-07,46,0,46
273,GTI2013,SG1V44937026,S44 ,ENGRO CORPORATION LIMITED,31-Dec-12,39,-2,37
379,GTI2012,SG1V44937026,S44 ,ENGRO CORP LTD,31-Dec-10,36,-5,31
407,GTI2011,SG1V44937026,S44 ,ENGRO CORPORATION LIMITED,31-Dec-09,35,-8,27
235,GTI2010,SG1V44937026,S44 ,ENGRO CORPORATION LIMITED,31-Dec-08,36,0,36
330,GTI2009,SG1V44937026,S44 ,ENGRO CORPORATION LIMITED,31-Dec-07,34,0,34
503,GTI2013,SG1V50937100,S46 ,SAN TEH LIMITED,31-Dec-12,31,-3,28
611,GTI2012,SG1V50937100,S46 ,SAN TEH LTD,31-Dec-10,32,-12,20
588,GTI2011,SG1V50937100,S46 ,SAN TEH LIMITED,31-Dec-09,34,-18,16
620,GTI2010,SG1V50937100,S46 ,SAN TEH LIMITED,31-Dec-08,32,-12,20
659,GTI2009,SG1V50937100,S46 ,SAN TEH LIMITED,31-Dec-07,23,-9,14
396,GTI2013,SG1V57937210,S47,SUPERIOR MULTI-PACKAGING LTD,31-Dec-12,35,-3,32
550,GTI2012,SG1V57937210,S47,SUPERIOR MULTI-PACKAGING LTD,31-Dec-10,30,-6,24
557,GTI2011,SG1V57937210,S47,SUPERIOR MULTI-PACKAGING LTD,31-Dec-09,41,-22,19
543,GTI2010,SG1V57937210,S47,SUPERIOR MULTI-PACKAGING LTD,31-Dec-08,44,-19,25
463,GTI2009,SG1V57937210,S47,SUPERIOR MULTI-PACKAGING LTD,31-Dec-07,37,-8,29
302,GTI2013,SG1V58937227,S48 ,SUPERBOWL HOLDINGS LIMITED,31-Dec-12,38,-2,36
317,GTI2012,SG1V58937227,S48 ,SUPERBOWL HLDGS LTD,31-Dec-10,33,0,33
254,GTI2011,SG1V58937227,S48 ,SUPERBOWL HOLDINGS LIMITED,31-Dec-09,41,-8,33
235,GTI2010,SG1V58937227,S48 ,SUPERBOWL HOLDINGS LIMITED,31-Dec-08,38,-2,36
292,GTI2009,SG1V58937227,S48 ,SUPERBOWL HOLDINGS LIMITED,31-Dec-07,41,-6,35
396,GTI2013,SG1V61937297,S49 ,SINGAPORE REINSURANCE COR LTD,31-Dec-12,40,-8,32
292,GTI2012,SG1V61937297,S49 ,SINGAPORE REINSURANCE CORP LTD,31-Dec-10,42,-8,34
458,GTI2011,SG1V61937297,S49 ,SINGAPORE REINSURANCE COR LTD,31-Dec-09,41,-16,25
417,GTI2010,SG1V61937297,S49 ,SINGAPORE REINSURANCE COR LTD,31-Dec-08,47,-17,30
463,GTI2009,SG1V61937297,S49 ,SINGAPORE REINSURANCE COR LTD,31-Dec-07,40,-11,29
12,GTI2013,SG1V70937494,S51 ,SEMBCORP MARINE LTD,31-Dec-12,75,11,86
14,GTI2012,SG1V70937494,S51 ,SEMBCORP MARINE LTD,31-Dec-10,71,8,79
14,GTI2011,SG1V70937494,S51 ,SEMBCORP MARINE LTD,31-Dec-09,65,8,73
17,GTI2010,SG1V70937494,S51 ,SEMBCORP MARINE LTD,31-Dec-08,62,1,63
11,GTI2009,SG1V70937494,S51 ,SEMBCORP MARINE LTD,31-Dec-07,64,-2,62
11,GTI2013,SG1V71937527,S53 ,SMRT CORPORATION LTD,31-Mar-12,89,-2,87
7,GTI2012,SG1V71937527,S53 ,SMRT CORP LTD,31-Mar-11,90,-1,89
6,GTI2011,SG1V71937527,S53 ,SMRT CORPORATION LTD,31-Mar-10,87,-1,86
2,GTI2010,SG1V71937527,S53 ,SMRT CORPORATION LTD,31-Mar-09,87,12,99
2,GTI2009,SG1V71937527,S53 ,SMRT CORPORATION LTD,31-Mar-08,85,3,88
207,GTI2013,SG1V73937608,S56 ,SAMUDERA SHIPPING LINE LTD,31-Dec-12,36,4,40
533,GTI2012,SG1V73937608,S56 ,SAMUDERA SHIPPING LINE LTD,31-Dec-10,38,-13,25
624,GTI2011,SG1V73937608,S56 ,SAMUDERA SHIPPING LINE LTD,31-Dec-09,32,-20,12
524,GTI2010,SG1V73937608,S56 ,SAMUDERA SHIPPING LINE LTD,31-Dec-08,38,-12,26
574,GTI2009,SG1V73937608,S56 ,SAMUDERA SHIPPING LINE LTD,31-Dec-07,37,-13,24
165,GTI2011,SG1V81937806,S57,SURFACE MOUNT TECH (HLDGS) LTD,31-Mar-10,37,0,37
82,GTI2010,SG1V81937806,S57,SURFACE MOUNT TECH (HLDGS) LTD,31-Mar-09,44,0,44
82,GTI2009,SG1V81937806,S57,SURFACE MOUNT TECH (HLDGS) LTD,31-Mar-08,46,-3,43
9,GTI2013,SG1V81937806,S58 ,SATS LTD.,31-Mar-12,75,14,89
8,GTI2012,SG1V81937806,S58 ,SATS LTD,31-Mar-11,70,14,84
5,GTI2011,SG1W02938031,S58 ,SATS LTD (FORMERLY SINGAPORE AIRPORT TRML SVCSLTD),31-Mar-10,74,14,88
9,GTI2010,SG1W02938031,S58 ,SINGAPORE AIRPORT TRML SVCSLTD,31-Mar-09,71,3,74
7,GTI2009,SG1W02938031,S58 ,SINGAPORE AIRPORT TRML SVCSLTD,31-Mar-08,72,-3,69
10,GTI2013,SG1W02938031,S59 ,SIA ENGINEERING COMPANY LTD,31-Mar-12,79,9,88
17,GTI2012,SG1W14938268,S59 ,SIA ENGINEERING COMPANY LTD,31-Mar-11,70,6,76
16,GTI2011,SG1W14938268,S59 ,SIA ENGINEERING CO LTD,31-Mar-10,63,9,72
12,GTI2010,SG1W14938268,S59 ,SIA ENGINEERING CO LTD,31-Mar-09,66,6,72
12,GTI2009,SG1W14938268,S59 ,SIA ENGINEERING CO LTD,31-Mar-08,58,3,61
57,GTI2013,SG1W14938268,S61 ,SBS TRANSIT LTD,31-Dec-12,54,6,60
39,GTI2012,SG1W16938290,S61 ,SBS TRANSIT LTD,31-Dec-10,58,0,58
52,GTI2011,SG1W16938290,S61 ,SBS TRANSIT LTD,31-Dec-09,50,-1,49
148,GTI2010,SG1W16938290,S61 ,SBS TRANSIT LTD,31-Dec-08,47,-7,40
407,GTI2009,SG1W16938290,S61 ,SBS TRANSIT LTD,31-Dec-07,40,-9,31
36,GTI2013,SG1W20938336,S63 ,SINGAPORE TECH ENGINEERING LTD,31-Dec-12,66,2,68
28,GTI2012,SG1W20938336,S63 ,SINGAPORE TECHNOLOGIES ENGINEERING LTD,31-Dec-10,63,5,68
23,GTI2011,SG1W20938336,S63 ,SINGAPORE TECH ENGINEERING LTD,31-Dec-09,60,5,65
25,GTI2010,SG1W20938336,S63 ,SINGAPORE TECH ENGINEERING LTD,31-Dec-08,48,8,56
46,GTI2009,SG1W20938336,S63 ,SINGAPORE TECH ENGINEERING LTD,31-Dec-07,47,0,47
1,GTI2013,SG1W30938821,S68 ,SINGAPORE EXCHANGE LIMITED,30-Jun-12,89,24,113
2,GTI2012,SG1W30938821,S68 ,SINGAPORE EXCHANGE LTD,30-Jun-11,81,24,105
2,GTI2011,SG1W30938821,S68 ,SINGAPORE EXCHANGE LIMITED,30-Jun-10,89,12,101
3,GTI2010,SG1W30938821,S68 ,SINGAPORE EXCHANGE LIMITED,30-Jun-09,81,12,93
3,GTI2009,SG1W30938821,S68 ,SINGAPORE EXCHANGE LIMITED,30-Jun-08,71,6,77
430,GTI2013,SG1W32938860,S69 ,SERIAL SYSTEM LTD,31-Dec-12,36,-5,31
196,GTI2012,SG1W32938860,S69 ,SERIAL SYSTEM LTD,31-Dec-10,38,0,38
430,GTI2011,SG1W32938860,S69 ,SERIAL SYSTEM LTD,31-Dec-09,34,-8,26
543,GTI2010,SG1W32938860,S69 ,SERIAL SYSTEM LTD,31-Dec-08,33,-8,25
505,GTI2009,SG1W32938860,S69 ,SERIAL SYSTEM LTD,31-Dec-07,35,-8,27
643,GTI2013,SG1W35938974,S71 ,SUNRIGHT LTD,31-Jul-12,20,-3,17
633,GTI2012,SG1W35938974,S71 ,SUNRIGHT LTD,31-Jul-11,21,-3,18
531,GTI2011,SG1W35938974,S71 ,SUNRIGHT LTD,31-Jul-10,24,-3,21
543,GTI2010,SG1W35938974,S71 ,SUNRIGHT LTD,31-Jul-09,27,-2,25
615,GTI2009,SG1W35938974,S71 ,SUNRIGHT LTD,31-Jul-08,23,-2,21
525,GTI2013,SG1W36938981,S73 ,STRATECH SYSTEMS LIMITED,31-Mar-12,36,-9,27
242,GTI2012,SG1W36938981,S73 ,STRATECH SYSTEMS LTD,31-Mar-10,36,0,36
281,GTI2011,SG1W36938981,S73 ,STRATECH SYSTEMS LIMITED,31-Mar-10,37,-5,32
115,GTI2010,SG1W36938981,S73 ,STRATECH SYSTEMS LIMITED,31-Mar-09,47,-5,42
228,GTI2009,SG1W36938981,S73 ,STRATECH SYSTEMS LIMITED,31-Mar-08,39,-2,37
612,GTI2013,SG1W37938998,S85 ,STRACO CORPORATION LIMITED,31-Dec-12,32,-11,21
533,GTI2012,SG1W37938998,S85 ,STRACO CORP LTD,31-Dec-10,34,-9,25
588,GTI2011,SG1W37938998,S85 ,STRACO CORPORATION LIMITED,31-Dec-09,26,-10,16
447,GTI2010,SG1W37938998,S85 ,STRACO CORPORATION LIMITED,31-Dec-08,29,0,29
505,GTI2009,SG1W37938998,S85 ,STRACO CORPORATION LIMITED,31-Dec-07,30,-3,27
326,GTI2013,SG1W38939029,T03 ,TAT HONG HOLDINGS LTD,31-Mar-12,33,2,35
317,GTI2012,SG1W38939029,T03 ,TAT HONG HLDGS LTD,31-Mar-11,33,0,33
281,GTI2011,SG1W38939029,T03 ,TAT HONG HOLDINGS LTD,31-Mar-10,40,-8,32
148,GTI2010,SG1W38939029,T03 ,TAT HONG HOLDINGS LTD,31-Mar-09,43,-3,40
330,GTI2009,SG1W38939029,T03 ,TAT HONG HOLDINGS LTD,31-Mar-08,40,-6,34
34,GTI2013,SG1W39939069,T04 ,THAKRAL CORPORATION LTD,31-Dec-12,62,9,71
73,GTI2012,SG1W39939069,T04 ,THAKRAL CORP LTD,31-Dec-10,49,0,49
62,GTI2011,SG1W39939069,T04 ,THAKRAL CORPORATION LTD,31-Dec-09,50,-3,47
99,GTI2010,SG1W39939069,T04 ,THAKRAL CORPORATION LTD,31-Dec-08,46,-3,43
266,GTI2009,SG1W39939069,T04 ,THAKRAL CORPORATION LTD,31-Dec-07,42,-6,36
544,GTI2013,SG1W40939082,T06 ,TIONG WOON CORPORATION HOLDING LTD,30-Jun-12,30,-4,26
565,GTI2012,SG1W40939082,T06 ,TIONG WOON CORP HLDG LTD,30-Jun-11,26,-3,23
430,GTI2011,SG1W40939082,T06 ,TIONG WOON CORP HOLDING LTD,30-Jun-10,30,-4,26
196,GTI2010,SG1W40939082,T06 ,TIONG WOON CORP HOLDING LTD,30-Jun-09,40,-2,38
591,GTI2009,SG1W40939082,T06 ,TIONG WOON CORP HOLDING LTD,30-Jun-08,28,-5,23
450,GTI2013,SG1W44939146,T08 ,TYE SOON LTD,31-Dec-12,35,-5,30
355,GTI2012,SG1W44939146,T08 ,TYE SOON LTD,31-Dec-10,31,1,32
377,GTI2011,SG1W44939146,T08 ,TYE SOON LTD,31-Dec-09,33,-5,28
564,GTI2010,SG1W44939146,T08 ,TYE SOON LTD,31-Dec-08,29,-5,24
634,GTI2009,SG1W44939146,T08 ,TYE SOON LTD,31-Dec-07,27,-8,19
598,GTI2013,SG1W49939232,T09 ,TT INTERNATIONAL LIMITED,31-Mar-12,29,-7,22
611,GTI2012,SG1W49939232,T09 ,TT INTERNATIONAL LTD,31-Mar-11,25,-5,20
514,GTI2011,SG1W49939232,T09 ,TT INTERNATIONAL LIMITED,31-Mar-10,29,-7,22
447,GTI2010,SG1W49939232,T09 ,TT INTERNATIONAL LIMITED,31-Mar-09,36,-7,29
140,GTI2009,SG1W49939232,T09 ,TT INTERNATIONAL LIMITED,31-Mar-08,42,-2,40
503,GTI2013,SG1W50939246,T12 ,TAT SENG PACKAGING GROUP LTD,31-Dec-12,36,-8,28
622,GTI2012,SG1W50939246,T12 ,TAT SENG PACKAGING GROUP LTD,31-Dec-10,30,-11,19
604,GTI2011,SG1W50939246,T12 ,TAT SENG PACKAGING GROUP LTD,31-Dec-09,31,-16,15
664,GTI2010,SG1W50939246,T12 ,TAT SENG PACKAGING GROUP LTD,31-Dec-08,27,-17,10
654,GTI2009,SG1W50939246,T12 ,TAT SENG PACKAGING GROUP LTD,31-Dec-07,32,-17,15
612,GTI2013,SG1W52939285,T13 ,RH PETROGAS LIMITED,31-Dec-12,31,-10,21
550,GTI2012,SG1W52939285,T13 ,RH PETROGAS LTD,31-Dec-10,29,-5,24
430,GTI2011,SG1W52939285,T13 ,RH PETROGAS (FORMERLY TRI-M TECHNOLOGIES (S) LTD),31-Dec-09,30,-4,26
323,GTI2010,SG1W52939285,T13 ,RH PETROGAS (FORMERLY TRI-M TECHNOLOGIES (S) LTD),31-Dec-08,35,-2,33
330,GTI2009,SG1W52939285,T13 ,TRI-M TECHNOLOGIES (S) LTD,31-Dec-07,36,-2,34
353,GTI2013,SG1W55939399,T14 ,TIANJIN ZHONG XIN PHARM GROUP,31-Dec-12,33,1,34
196,GTI2012,SG1W55939399,T14 ,TIANJIN ZHONG XIN PHARMECEUTICAL GROUP CORP LTD,31-Dec-10,37,1,38
254,GTI2011,SG1W55939399,T14 ,TIANJIN ZHONG XIN PHARM GROUP,31-Dec-09,35,-2,33
296,GTI2010,SG1W55939399,T14 ,TIANJIN ZHONG XIN PHARM GROUP,31-Dec-08,36,-2,34
196,GTI2009,SG1W55939399,T14 ,TIANJIN ZHONG XIN PHARM GROUP,31-Dec-07,43,-5,38
566,GTI2013,SG1W58939412,T16 ,CHINA DAIRY GROUP LTD,31-Dec-12,33,-8,25
455,GTI2012,SG1W58939412,T16 ,CHINA DAIRY GROUP LTD,31-Dec-10,33,-5,28
301,GTI2011,SG1W58939412,T16 ,CHINA DAIRY GROUP LTD,31-Dec-09,33,-2,31
564,GTI2010,SG1W58939412,T16 ,CHINA DAIRY GROUP LTD,31-Dec-08,27,-3,24
529,GTI2009,SG1W58939412,T16 ,CHINA DAIRY GROUP LTD,31-Dec-07,29,-3,26
450,GTI2013,SG1W59939429,T19 ,TRANSVIEW HOLDINGS LIMITED,31-Oct-12,35,-5,30
565,GTI2012,SG1W59939429,T19 ,TRANSVIEW HLDGS LTD,31-Oct-10,29,-6,23
496,GTI2011,SG1W59939429,T19 ,TRANSVIEW HOLDINGS LIMITED,31-Oct-09,34,-11,23
323,GTI2010,SG1W59939429,T19 ,TRANSVIEW HOLDINGS LIMITED,31-Oct-08,36,-3,33
292,GTI2009,SG1W59939429,T19 ,TRANSVIEW HOLDINGS LIMITED,31-Oct-07,41,-6,35
639,GTI2013,SG1W61939482,T20 ,SCINTRONIX CORPORATION LTD.,31-Dec-12,44,-26,18
633,GTI2012,SG1W61939482,T20 ,SCINTRONIX CORP LTD,30-Jun-11,36,-18,18
575,GTI2011,SG1W61939482,T20 ,SCINTRONIX CORPORATION LTD. (FORMERLY TTL HOLDINGS LTD),30-Jun-10,35,-18,17
148,GTI2010,SG1W61939482,T20 ,SCINTRONIX CORPORATION LTD. (FORMERLY TTL HOLDINGS LTD),30-Jun-09,45,-5,40
357,GTI2009,SG1W61939482,T20 ,TTL HOLDINGS LIMITED,30-Jun-08,40,-7,33
22,GTI2013,SG1W63939514,T24 ,TUAN SING HOLDINGS LIMITED,31-Dec-12,67,13,80
25,GTI2012,SG1W63939514,T24 ,TUAN SING HLDGS LTD,31-Dec-10,60,9,69
20,GTI2011,SG1W63939514,T24 ,TUAN SING HOLDINGS LIMITED,31-Dec-09,62,6,68
33,GTI2010,SG1W63939514,T24 ,TUAN SING HOLDINGS LIMITED,31-Dec-08,43,9,52
46,GTI2009,SG1W64939547,T24 ,TUAN SING HOLDINGS LIMITED,31-Dec-07,47,0,47
503,GTI2013,SG1W64939547,T26,TSIT WING INTL HOLDINGS LTD,31-Dec-12,43,-15,28
268,GTI2012,SG1W64939547,T26,TSIT WING INTERNATIONAL HLDGS LTD,31-Dec-10,40,-5,35
325,GTI2011,SG1W64939547,T26,TSIT WING INTL HOLDINGS LTD,31-Dec-09,38,-8,30
296,GTI2010,SG1W64939547,T26,TSIT WING INTL HOLDINGS LTD,31-Dec-08,40,-6,34
485,GTI2009,SG1W66939735,T26,TSIT WING INTL HOLDINGS LTD,31-Dec-07,31,-3,28
649,GTI2013,SG1W66939735,T28 ,TELEDATA (SINGAPORE) LTD,31-Dec-12,40,-25,15
622,GTI2012,SG1W66939735,T28 ,TELEDATA (S) LTD,31-Dec-10,38,-19,19
624,GTI2011,SG1W66939735,T28 ,TELEDATA (SINGAPORE) LTD,31-Dec-09,33,-21,12
352,GTI2010,SG1W66939735,T28 ,TELEDATA (SINGAPORE) LTD,31-Dec-08,32,0,32
292,GTI2009,SG1W76939881,T28 ,TELEDATA (SINGAPORE) LTD,31-Dec-07,35,0,35
145,GTI2013,SG1W76939881,T35 ,SUNNINGDALE TECH LTD,31-Dec-12,45,0,45
149,GTI2012,SG1W76939881,T35 ,SUNNINGDALE TECH LTD,31-Dec-10,38,3,41
165,GTI2011,SG1W76939881,T35 ,SUNNINGDALE TECH LTD,31-Dec-09,37,0,37
72,GTI2010,SG1W76939881,T35 ,SUNNINGDALE TECH LTD,31-Dec-08,45,0,45
140,GTI2009,SG1W77939914,T35 ,SUNNINGDALE TECH LTD,31-Dec-07,40,0,40
15,GTI2013,SG1W77939914,T39 ,SINGAPORE PRESS HLDGS LTD,31-Aug-12,78,5,83
11,GTI2012,SG1W77939914,T39 ,SINGAPORE PRESS HLDGS LTD,31-Aug-11,73,9,82
14,GTI2011,SG1W77939914,T39 ,SINGAPORE PRESS HLDGS LTD,31-Aug-10,66,7,73
5,GTI2010,SG1W77939914,T39 ,SINGAPORE PRESS HLDGS LTD,31-Aug-09,67,9,76
24,GTI2009,SG1W79939920,T39 ,SINGAPORE PRESS HLDGS LTD,31-Aug-08,53,0,53
67,GTI2013,SG1W79939920,T41 ,TELECHOICE INTERNATIONAL LTD,31-Dec-12,56,0,56
89,GTI2012,SG1W79939920,T41 ,TELECHOICE INTERNATIONAL LTD,31-Dec-10,46,0,46
92,GTI2011,SG1W79939920,T41 ,TELECHOICE INTERNATIONAL LTD,31-Dec-09,45,-3,42
43,GTI2010,SG1W79939920,T41 ,TELECHOICE INTERNATIONAL LTD,31-Dec-08,49,0,49
26,GTI2009,SG1W81939983,T41 ,TELECHOICE INTERNATIONAL LTD,31-Dec-07,55,-3,52
302,GTI2013,SG1W81939983,T42 ,CHINA AUTO ELECTRONICS GRP LTD,31-Dec-12,35,1,36
317,GTI2012,SG1W81939983,T42 ,CHINA AUTO ELECTRONICS GROUP LTD,31-Dec-10,36,-3,33
531,GTI2011,SG1W81939983,T42 ,CHINA AUTO ELECTRONICS GRP LTD,31-Dec-09,32,-11,21
267,GTI2010,SG1W86940333,T42 ,CHINA AUTO ELECTRONICS GRP LTD,31-Dec-08,38,-3,35
357,GTI2009,SG1W86940333,T42 ,CHINA AUTO ELECTRONICS GRP LTD,31-Dec-07,36,-3,33
252,GTI2013,SG1W86940333,T43 ,TECHCOMP (HOLDINGS) LIMITED,31-Dec-12,38,0,38
317,GTI2012,SG1W86940333,T43 ,TECHCOMP (HLDGS) LTD,31-Dec-10,35,-2,33
301,GTI2011,SG1W86940333,T43 ,TECHCOMP (HOLDINGS) LIMITED,31-Dec-09,35,-4,31
323,GTI2010,SG1W89940439,T43 ,TECHCOMP (HOLDINGS) LIMITED,31-Dec-08,38,-5,33
529,GTI2009,SG1W89940439,T43 ,TECHCOMP (HOLDINGS) LIMITED,31-Dec-07,36,-10,26
252,GTI2013,SG1W89940439,T55 ,TRANSPAC INDUSTRIAL HLDGS LTD,31-Dec-12,34,4,38
292,GTI2012,SG1W89940439,T55 ,TRANSPAC INDUSTRIAL HLDGS LTD,31-Dec-10,31,3,34
76,GTI2011,SG1W93940508,T55 ,TRANSPAC INDUSTRIAL HLDGS LTD,31-Dec-09,38,6,44
395,GTI2010,SG1W93940508,T55 ,TRANSPAC INDUSTRIAL HLDGS LTD,31-Dec-08,31,0,31
266,GTI2009,SG1W93940508,T55 ,TRANSPAC INDUSTRIAL HLDGS LTD,31-Dec-07,36,0,36
649,GTI2013,SG1W93940508,T57,SHANGHAI ASIA HOLDINGS LIMITED,31-Dec-12,33,-18,15
633,GTI2012,SG1X07940643,T57,SHANGHAI ASIA HLDGS LTD,31-Dec-10,34,-16,18
544,GTI2011,SG1X07940643,T57,SHANGHAI ASIA HOLDINGS LIMITED,31-Dec-09,42,-22,20
148,GTI2010,SG1X07940643,T57,SHANGHAI ASIA HOLDINGS LIMITED,31-Dec-08,42,-2,40
196,GTI2009,SG1X07940643,T57,SHANGHAI ASIA HOLDINGS LIMITED,31-Dec-07,46,-8,38
373,GTI2013,SG1X09940682,T77 ,SOUTHERN PACKAGING GROUP LTD,31-Dec-12,37,-4,33
483,GTI2012,SG1X09940682,T77 ,SOUTHERN PACKAGING GROUP LTD,31-Dec-10,29,-2,27
346,GTI2011,SG1X09940682,T77 ,SOUTHERN PACKAGING GROUP LTD,31-Dec-09,33,-4,29
235,GTI2010,SG1X09940682,T77 ,SOUTHERN PACKAGING GROUP LTD,31-Dec-08,35,1,36
140,GTI2009,SG1X13940751,T77 ,SOUTHERN PACKAGING GROUP LTD,31-Dec-07,42,-2,40
207,GTI2013,SG1X13940751,T80,SINOBEST TECHNOLOGY HLDGS LTD,31-Dec-12,37,3,40
410,GTI2012,SG1X13940751,T80,SINOBEST TECHNOLOGY HLDGS LTD,31-Dec-10,30,0,30
129,GTI2011,SG1X13940751,T80,SINOBEST TECHNOLOGY HLDGS LTD.,31-Dec-09,39,1,40
267,GTI2010,SG1X13940751,T80,SINOBEST TECHNOLOGY HLDGS LTD.,31-Dec-08,35,0,35
330,GTI2009,SG1X16940808,T80,SINOBEST TECHNOLOGY HLDGS LTD.,31-Dec-07,37,-3,34
525,GTI2013,SG1X16940808,TO9 ,"STX PAN OCEAN CO., LTD.",31-Dec-11,29,-2,27
455,GTI2012,SG1X16940808,TO9 ,STX PAN OCEAN CO LTD,31-Dec-10,33,-5,28
346,GTI2011,SG1X16940808,TO9 ,"STX PAN OCEAN CO., LTD.",31-Dec-09,31,-2,29
417,GTI2010,SG1X17940831,TO9 ,"STX PAN OCEAN CO., LTD.",31-Dec-08,35,-5,30
330,GTI2009,SG1X17940831,TO9 ,"STX PAN OCEAN CO., LTD.",31-Dec-07,33,1,34
207,GTI2013,SG1X17940831,U01 ,UNITED FOOD HOLDINGS LIMITED,31-Dec-12,40,0,40
268,GTI2012,SG1X17940831,U01 ,UNITED FOOD HLDGS LTD,31-Dec-10,38,-3,35
140,GTI2011,SG1X17940831,U01 ,UNITED FOOD HOLDINGS LIMITED,31-Dec-09,39,0,39
216,GTI2010,SG1X21941023,U01 ,UNITED FOOD HOLDINGS LIMITED,31-Dec-08,37,0,37
228,GTI2009,SG1X21941023,U01 ,UNITED FOOD HOLDINGS LIMITED,31-Dec-07,40,-3,37
46,GTI2013,SG1X21941023,U04 ,UNITED ENGINEERS LTD ORD,31-Dec-12,55,9,64
66,GTI2012,SG1X21941023,U04 ,UNITED ENGINEERS LTD ,31-Dec-10,50,0,50
42,GTI2011,SG1X25941052,U04 ,UNITED ENGINEERS LTD ORD,31-Dec-09,45,6,51
129,GTI2010,SG1X25941052,U04 ,UNITED ENGINEERS LTD ORD,31-Dec-08,44,-3,41
111,GTI2009,SG1X25941052,U04 ,UNITED ENGINEERS LTD ORD,31-Dec-07,41,0,41
326,GTI2013,SG1X25941052,U06 ,UNITED INDUSTRIAL CORP LTD,31-Dec-12,41,-6,35
550,GTI2012,SG1X27941084,U06 ,UNITED INDUSTRIAL CORP LTD,31-Dec-10,33,-9,24
377,GTI2011,SG1X27941084,U06 ,UNITED INDUSTRIAL CORP LTD,31-Dec-09,34,-6,28
498,GTI2010,SG1X27941084,U06 ,UNITED INDUSTRIAL CORP LTD,31-Dec-08,33,-6,27
111,GTI2009,SG1X27941084,U06 ,UNITED INDUSTRIAL CORP LTD,31-Dec-07,44,-3,41
450,GTI2013,SG1X27941084,U07,UNITED INTL SECURITIES LTD,31-Dec-12,36,-6,30
455,GTI2012,SG1X41941300,U07,UNITED INTERNATIONAL SECURITIES LTD,31-Dec-10,34,-6,28
611,GTI2011,SG1X41941300,U07,UNITED INTL SECURITIES LTD,31-Dec-09,29,-15,14
628,GTI2010,SG1X41941300,U07,UNITED INTL SECURITIES LTD,31-Dec-08,28,-9,19
111,GTI2009,SG1X41941300,U07,UNITED INTL SECURITIES LTD,31-Dec-07,44,-3,41
91,GTI2013,SG1X43941639,U09 ,UPP HOLDINGS LIMITED,31-Dec-12,46,5,51
131,GTI2012,SG1X43941639,U09 ,UPP HLDGS LTD,31-Dec-10,45,-3,42
186,GTI2011,SG1X43941639,U09 ,UPP HOLDINGS LIMITED (FORMERLY UNITED PULP & PAPER CO LTD),31-Dec-09,39,-3,36
498,GTI2010,SG1X43941639,U09 ,UNITED PULP & PAPER CO. LTD,31-Dec-08,33,-6,27
566,GTI2013,SG1X43941639,U10 ,UOB-KAY HIAN HOLDINGS LIMITED,31-Dec-12,30,-5,25
565,GTI2012,SG1X55941717,U10 ,UOB-KAY HIAN HLDGS LTD,31-Dec-10,29,-6,23
544,GTI2011,SG1X55941717,U10 ,UOB-KAY HIAN HOLDINGS LIMITED,31-Dec-09,28,-8,20
352,GTI2010,SG1X55941717,U10 ,UOB-KAY HIAN HOLDINGS LIMITED,31-Dec-08,32,0,32
383,GTI2009,SG1X55941717,U10 ,UOB-KAY HIAN HOLDINGS LIMITED,31-Dec-07,32,0,32
41,GTI2013,SG1X55941717,U11 ,UNITED OVERSEAS BANK LTD,31-Dec-12,56,9,65
105,GTI2012,SG1X59941754,U11 ,UNITED OVERSEAS BANK LTD,31-Dec-10,53,-9,44
118,GTI2011,SG1X59941754,U11 ,UNITED OVERSEAS BANK LTD,31-Dec-09,47,-6,41
33,GTI2010,SG1X59941754,U11 ,UNITED OVERSEAS BANK LTD,31-Dec-08,52,0,52
15,GTI2009,SG1X59941754,U11 ,UNITED OVERSEAS BANK LTD,31-Dec-07,61,-6,55
396,GTI2013,SG1X63941782,U13 ,UNITED OVERSEAS INSURANCE LTD,31-Dec-12,35,-3,32
268,GTI2012,SG1X63941782,U13 ,UNITED OVERSEAS INSURANCE LTD,31-Dec-10,38,-3,35
230,GTI2011,SG1X63941782,U13 ,UNITED OVERSEAS INSURANCE LTD,31-Dec-09,40,-6,34
82,GTI2010,SG1X63941782,U13 ,UNITED OVERSEAS INSURANCE LTD,31-Dec-08,47,-3,44
24,GTI2009,SG1X63941782,U13 ,UNITED OVERSEAS INSURANCE LTD,31-Dec-07,53,0,53
84,GTI2013,SG1X69942156,U14 ,UOL GROUP LIMITED,31-Dec-12,55,-3,52
42,GTI2012,SG1X69942156,U14 ,UOL GROUP LTD,31-Dec-10,59,-3,56
46,GTI2011,SG1X69942156,U14 ,UOL GROUP LIMITED,31-Dec-09,53,-3,50
115,GTI2010,SG1X69942156,U14 ,UOL GROUP LIMITED,31-Dec-08,45,-3,42
166,GTI2009,SG1X76942223,U14 ,UOL GROUP LIMITED,31-Dec-07,42,-3,39
480,GTI2013,SG1X76942223,U18 ,UNIFIED COMMUNICATIONS HOLDINGS LTD,31-Dec-12,36,-7,29
533,GTI2012,SG1X76942223,U18 ,UNIFIED COMMUNICATIONS HLDGS LTD,31-Dec-10,30,-5,25
430,GTI2011,SG1X76942223,U18 ,UNIFIED COMMUNICATIONS HLDGLTD,31-Dec-09,30,-4,26
395,GTI2010,SG1X84942272,U18 ,UNIFIED COMMUNICATIONS HLDGLTD,31-Dec-08,33,-2,31
357,GTI2009,SG1X84942272,U18 ,UNIFIED COMMUNICATIONS HLDGLTD,31-Dec-07,35,-2,33
503,GTI2013,SG1X84942272,U19 ,UNITED ENVIROTECH LTD,31-Mar-12,32,-4,28
149,GTI2012,SG1X84942272,U19 ,UNITED ENVIROTECH LTD,31-Mar-11,38,3,41
254,GTI2011,SG1Y15944495,U19 ,UNITED ENVIROTECH LTD,31-Mar-10,37,-4,33
82,GTI2010,SG1Y15944495,U19 ,UNITED ENVIROTECH LTD,31-Mar-09,43,1,44
292,GTI2009,SG1Y31945526,U19 ,UNITED ENVIROTECH LTD,31-Mar-08,37,-2,35
230,GTI2013,SG1Y31945526,U77 ,SARIN TECHNOLOGIES LTD,31-Dec-12,44,-5,39
292,GTI2012,SG1Y33945565,U77 ,SARIN TECHNOLOGIES LTD,31-Dec-10,37,-3,34
346,GTI2011,SG1Y33945565,U77 ,SARIN TECHNOLOGIES LTD,31-Dec-09,38,-9,29
417,GTI2010,SG1Y37945678,U77 ,SARIN TECHNOLOGIES LTD,31-Dec-08,40,-10,30
485,GTI2009,SG1Y37945678,U77 ,SARIN TECHNOLOGIES LTD,31-Dec-07,42,-14,28
4,GTI2013,SG1Y42946521,U96 ,SEMBCORP INDUSTRIES LTD,31-Dec-12,86,20,106
4,GTI2012,SG1Y42946521,U96 ,SEMBCORP INDUSTRIES LTD,31-Dec-10,82,11,93
11,GTI2011,SG1Y42946521,U96 ,SEMBCORP INDUSTRIES LTD,31-Dec-09,69,8,77
7,GTI2010,SG1Y42946521,U96 ,SEMBCORP INDUSTRIES LTD,31-Dec-08,74,1,75
22,GTI2009,SG1Y42946521,U96 ,SEMBCORP INDUSTRIES LTD,31-Dec-07,60,-6,54
52,GTI2013,SG1Y44946602,V01 ,VICOM LTD,31-Dec-12,52,9,61
41,GTI2012,SG1Y44946602,V01 ,VICOM LTD,31-Dec-10,48,9,57
34,GTI2011,SG1Y44946602,V01 ,VICOM LTD,31-Dec-09,53,2,55
352,GTI2010,SG1Y45946619,V01 ,VICOM LTD,31-Dec-08,42,-10,32
330,GTI2009,SG1Y45946619,V01 ,VICOM LTD,31-Dec-07,48,-14,34
52,GTI2013,SG1Y51946677,V03 ,VENTURE CORPORATION LIMITED,31-Dec-12,63,-2,61
131,GTI2012,SG1Y51946677,V03 ,VENTURE CORP LTD,31-Dec-10,49,-7,42
149,GTI2011,SG1Y54946807,V03 ,VENTURE CORPORATION LIMITED,31-Dec-09,48,-10,38
129,GTI2010,SG1Y54946807,V03 ,VENTURE CORPORATION LIMITED,31-Dec-08,44,-3,41
53,GTI2009,SG1Y54946807,V03 ,VENTURE CORPORATION LIMITED,31-Dec-07,46,0,46
373,GTI2013,SG1Y70948001,V69 ,UNION STEEL HOLDINGS LIMITED,30-Jun-12,41,-8,33
455,GTI2012,SG1Y70948001,V69 ,UNION STEEL HLDGS LTD,30-Jun-11,36,-8,28
210,GTI2011,SG1Y74948866,V69 ,UNION STEEL HOLDINGS LIMITED,30-Jun-10,34,1,35
115,GTI2010,SG1Y74948866,V69 ,UNION STEEL HOLDINGS LIMITED,30-Jun-09,39,3,42
97,GTI2009,SG1Y75948873,V69 ,UNION STEEL HOLDINGS LIMITED,30-Jun-08,39,3,42
23,GTI2013,SG1Y75948873,W01 ,WBL CORPORATION LIMITED,30-Sep-12,73,6,79
15,GTI2012,SG1Y75948873,W01 ,WBL CORP LTD,30-Sep-11,72,6,78
9,GTI2011,SG1Y78948920,W01 ,WBL CORPORATION LIMITED,30-Sep-10,69,9,78
33,GTI2009,SG1Y78948920,W01 ,WBL CORPORATION LIMITED,30-Sep-08,51,0,51
91,GTI2013,SG1Y79949026,W05 ,WING TAI HLDGS LTD,30-Jun-12,57,-6,51
105,GTI2012,SG1Y79949026,W05 ,WING TAI HLDGS LTD,30-Jun-11,47,-3,44
346,GTI2011,SG1Y80949072,W05 ,WING TAI HLDGS LTD,30-Jun-10,35,-6,29
267,GTI2010,SG1Y80949072,W05 ,WING TAI HLDGS LTD,30-Jun-09,35,0,35
485,GTI2009,SG1Y93950240,W05 ,WING TAI HLDGS LTD,30-Jun-08,34,-6,28
207,GTI2013,SG1Y93950240,W12 ,WILLAS-ARRAY ELECTRONICS (HOLDINGS) LTD,31-Mar-12,44,-4,40
92,GTI2012,SG1Y93950240,W12 ,WILLAS-ARRAY ELEC (HLDGS) LTD,31-Mar-11,42,3,45
186,GTI2011,SG1Y93950240,W12 ,WILLAS-ARRAY ELEC (HLDGS) LTD,31-Mar-10,40,-4,36
196,GTI2010,SG1Y93950240,W12 ,WILLAS-ARRAY ELEC (HLDGS) LTD,31-Mar-09,40,-2,38
292,GTI2009,SG1Y97950360,W12 ,WILLAS-ARRAY ELEC (HLDGS) LTD,31-Mar-08,43,-8,35
252,GTI2013,SG1Y97950360,W81 ,SKY CHINA PETROLEUM SVCS LTD,31-Dec-12,40,-2,38
410,GTI2012,SG1Z04950510,W81 ,SKY CHINA PETROLEUM SERVICES LTD,31-Dec-09,33,-3,30
407,GTI2011,SG1Z04950510,W81 ,SKY CHINA PETROLEUM SVCS LTD.,31-Dec-09,32,-5,27
235,GTI2010,SG1Z05950543,W81 ,SKY CHINA PETROLEUM SVCS LTD.,31-Dec-08,41,-5,36
166,GTI2009,SG1Z05950543,W81 ,SKY CHINA PETROLEUM SVCS LTD.,31-Dec-07,42,-3,39
242,GTI2012,SG1Z16951381,X06 ,SINOPIPE HLDGS LTD,31-Dec-10,32,4,36
377,GTI2011,SG1Z16951381,X06 ,SINOPIPE HOLDINGS LIMITED,31-Dec-09,33,-5,28
267,GTI2010,SG1Z19951446,X06 ,SINOPIPE HOLDINGS LIMITED,31-Dec-08,34,1,35
591,GTI2009,SG1Z19951446,X06 ,SINOPIPE HOLDINGS LIMITED,31-Dec-07,28,-5,23
373,GTI2013,SG1Z21951640,X27 ,SHANGHAI TURBO ENTERPRISES LTD.,31-Dec-12,30,3,33
436,GTI2012,SG1Z21951640,X27 ,SHANGHAI TURBO ENTERPRISES LTD,31-Dec-10,28,1,29
346,GTI2011,SG1Z26952619,X27 ,SHANGHAI TURBO ENTERPRISES LTD,31-Dec-09,29,0,29
395,GTI2010,SG1Z26952619,X27 ,SHANGHAI TURBO ENTERPRISES LTD,31-Dec-08,33,-2,31
463,GTI2009,SG1Z28952732,X27 ,SHANGHAI TURBO ENTERPRISES LTD,31-Dec-07,34,-5,29
450,GTI2013,SG1Z28952732,X64 ,STAR PHARMACEUTICAL LIMITED,31-Dec-12,32,-2,30
379,GTI2012,SG1Z33953592,X64 ,STAR PHARMACEUTICAL LTD,31-Dec-10,34,-3,31
325,GTI2011,SG1Z33953592,X64 ,STAR PHARMACEUTICAL LIMITED,31-Dec-09,35,-5,30
323,GTI2010,SG1Z40953700,X64 ,STAR PHARMACEUTICAL LIMITED,31-Dec-08,35,-2,33
166,GTI2009,SG1Z40953700,X64 ,STAR PHARMACEUTICAL LIMITED,31-Dec-07,41,-2,39
525,GTI2013,SG1Z42953799,Y02 ,YONGNAM HOLDINGS LIMITED,31-Dec-12,32,-5,27
500,GTI2012,SG1Z42953799,Y02 ,YONGNAM HLDGS LTD,31-Dec-10,29,-3,26
301,GTI2011,SG1Z42953799,Y02 ,YONGNAM HOLDINGS LIMITED,31-Dec-09,39,-8,31
267,GTI2010,SG1Z42953799,Y02 ,YONGNAM HOLDINGS LIMITED,31-Dec-08,44,-9,35
407,GTI2009,SG1Z42953799,Y02 ,YONGNAM HOLDINGS LIMITED,31-Dec-07,42,-11,31
108,GTI2013,SG1Z45953804,Y03 ,YEO HIAP SENG LTD,31-Dec-12,55,-6,49
73,GTI2012,SG1Z45953804,Y03 ,YEO HIAP SENG LTD,31-Dec-10,52,-3,49
186,GTI2011,SG1Z68955660,Y03 ,YEO HIAP SENG LTD,31-Dec-09,39,-3,36
235,GTI2010,SG1Z68955660,Y03 ,YEO HIAP SENG LTD,31-Dec-08,39,-3,36
166,GTI2009,SG1Z71955905,Y03 ,YEO HIAP SENG LTD,31-Dec-07,42,-3,39
396,GTI2013,SG1Z71955905,Y06 ,YOUYUE INTERNATIONAL LIMITED,31-Dec-12,37,-5,32
268,GTI2012,SG1Z73955945,Y06 ,YOUCAN FOODS INTERNATIONAL LTD,31-Dec-10,38,-3,35
281,GTI2011,SG1Z73955945,Y06 ,YOUCAN FOODS INTERNATIONAL LTD,31-Dec-09,37,-5,32
352,GTI2010,SG1Z75955968,Y06 ,YOUCAN FOODS INTERNATIONAL LTD,31-Dec-08,35,-3,32
558,GTI2009,SG2A71957016,Y06 ,YOUCAN FOODS INTERNATIONAL LTD,31-Dec-07,33,-8,25
108,GTI2013,SG2A71957016,Y07 ,GLOBAL YELLOW PAGES LIMITED,31-Mar-12,46,3,49
149,GTI2012,SG2B09957087,Y07 ,GLOBAL YELLOW PAGES LTD,31-Mar-11,38,3,41
92,GTI2011,SG2B09957087,Y07 ,GLOBAL YELLOW PAGES LIMITED (FORMERLY YELLOW PAGES(SINGAPORE)LIMITED),31-Mar-10,39,3,42
72,GTI2010,SG2B54957198,Y07 ,GLOBAL YELLOW PAGES LIMITED,31-Mar-09,45,0,45
228,GTI2009,SG2B54957198,Y07 ,YELLOW PAGES(SINGAPORE)LIMITED,31-Mar-08,49,-12,37
273,GTI2013,SG2B54957198,Y08 ,YHI INTERNATIONAL LIMITED,31-Dec-12,36,1,37
455,GTI2012,SG2B54957198,Y08 ,YHI INTERNATIONAL LTD,31-Dec-10,34,-6,28
377,GTI2011,SG2B54957198,Y08 ,YHI INTERNATIONAL LIMITED,31-Dec-09,36,-8,28
235,GTI2010,SG2B80958517,Y08 ,YHI INTERNATIONAL LIMITED,31-Dec-08,42,-6,36
292,GTI2009,SG2B80958517,Y08 ,YHI INTERNATIONAL LIMITED,31-Dec-07,44,-9,35
430,GTI2013,SG2B80958517,Y34,CHINA MINING INTERNATIONAL LTD,31-Dec-12,31,0,31
317,GTI2012,SG2B80958517,Y34,SUNSHINE HLDGS LTD,31-Dec-10,33,0,33
165,GTI2011,SG2B80958517,Y34,SUNSHINE HOLDINGS LIMITED,31-Dec-09,34,3,37
216,GTI2010,SG2B83959223,Y34,SUNSHINE HOLDINGS LIMITED,31-Dec-08,34,3,37
166,GTI2009,SG2B83959223,Y34,SUNSHINE HOLDINGS LIMITED,31-Dec-07,36,3,39
638,GTI2011,SG2B83959223,Y35,SUN EAST GROUP LIMITED,30-Jun-10,17,-9,8
447,GTI2010,SG2B83959223,Y35,SUN EAST GROUP LIMITED,30-Jun-08,36,-7,29
292,GTI2009,SG2B83959223,Y35,SUN EAST GROUP LIMITED,30-Jun-08,41,-6,35
115,GTI2013,SG2B84959255,Y35 ,CEFC INTERNATIONAL LIMITED,31-Dec-12,47,1,48
641,GTI2012,SG2B84959255,Y35 ,SUN EAST GROUP LTD,30-Jun-11,30,-13,17
430,GTI2013,SG2B89959318,Y45 ,SINGAPORE WINDSOR HOLDINGS LIMITED,31-Mar-12,33,-2,31
355,GTI2012,SG2B89959318,Y45 ,SINGAPORE WINDSOR HLDGS LTD,31-Mar-11,32,0,32
301,GTI2011,SG2B89959318,Y45 ,SINGAPORE WINDSOR HOLDINGS LTD,31-Mar-10,33,-2,31
323,GTI2010,SG2B89959318,Y45 ,SINGAPORE WINDSOR HOLDINGS LTD,31-Mar-09,35,-2,33
442,GTI2009,SG2B91959363,Y45 ,SINGAPORE WINDSOR HOLDINGS LTD,31-Mar-08,35,-5,30
273,GTI2013,SG2B91959363,Y92 ,THAI BEVERAGE PUBLIC CO LTD,31-Dec-12,33,4,37
196,GTI2012,SG2B93959478,Y92 ,THAI BEVERAGE PUBLIC COMPANY LTD,31-Dec-10,34,4,38
76,GTI2011,SG2B93959478,Y92 ,THAI BEVERAGE PUBLIC CO LTD,31-Dec-09,40,4,44
64,GTI2010,SG2B95959500,Y92 ,THAI BEVERAGE PUBLIC CO LTD,31-Dec-08,40,6,46
33,GTI2009,SG2B95959500,Y92 ,THAI BEVERAGE PUBLIC CO LTD,31-Dec-07,48,3,51
373,GTI2013,SG2B96959558,Z01 ,ZAGRO ASIA LIMITED,31-Dec-12,33,0,33
500,GTI2012,SG2B96959558,Z01 ,ZAGRO ASIA LTD,31-Dec-10,26,0,26
377,GTI2011,SG2B96959558,Z01 ,ZAGRO ASIA LIMITED,31-Dec-09,28,0,28
417,GTI2010,SG2B96959558,Z01 ,ZAGRO ASIA LIMITED,31-Dec-08,30,0,30
558,GTI2009,SG2B96959558,Z01 ,ZAGRO ASIA LIMITED,31-Dec-07,27,-2,25
612,GTI2013,SG2C00960329,Z02 ,CHINA POWERPLUS LIMITED,31-Dec-12,29,-8,21
587,GTI2012,SG2C00960329,Z02 ,CHINA POWERPLUS LTD,31-Dec-10,27,-5,22
531,GTI2011,SG2C00960329,Z02 ,CHINA POWERPLUS LIMITED,31-Dec-09,26,-5,21
468,GTI2010,SG2C00960329,Z02 ,CHINA POWERPLUS LIMITED,31-Dec-08,33,-5,28
357,GTI2009,SG2C00960329,Z02 ,CHINA POWERPLUS LIMITED,31-Dec-07,35,-2,33
91,GTI2013,SG2C01960336,Z25 ,YANLORD LAND GROUP LIMITED,31-Dec-12,48,3,51
196,GTI2012,SG2C01960336,Z25 ,YANLORD LAND GROUP LTD,31-Dec-10,35,3,38
92,GTI2011,SG2C04960473,Z25 ,YANLORD LAND GROUP LIMITED,31-Dec-09,39,3,42
48,GTI2010,SG2C04960473,Z25 ,YANLORD LAND GROUP LIMITED,31-Dec-08,45,3,48
111,GTI2009,SG2C12961455,Z25 ,YANLORD LAND GROUP LIMITED,31-Dec-07,38,3,41
74,GTI2013,SG2C12961455,Z59 ,YOMA STRATEGIC HOLDINGS 100,31-Mar-12,53,1,54
177,GTI2012,SG2C12961455,Z59 ,YOMA STRATEGIC HLDGS LTD,31-Mar-11,35,4,39
346,GTI2011,SG2C12961455,Z59 ,YOMA STRATEGIC HOLDINGS LTD,31-Mar-10,34,-5,29
296,GTI2010,SG2C12961455,Z59 ,YOMA STRATEGIC HOLDINGS LTD,31-Mar-09,37,-3,34
166,GTI2009,SG2C13961462,Z59 ,YOMA STRATEGIC HOLDINGS LTD,31-Mar-08,42,-3,39
2,GTI2013,SG2C13961462,Z74 ,SINGAPORE TELECOMMUNICATIONS LTD,31-Mar-12,83,29,112
1,GTI2012,SG2C13961462,Z74 ,SINGAPORE TELECOMMUNICATIONS LTD,31-Mar-11,79,32,111
1,GTI2011,SG2C13961462,Z74 ,SINGTEL,31-Mar-10,80,29,109
1,GTI2010,SG2C13961462,Z74 ,SINGTEL,31-Mar-09,83,20,103
1,GTI2009,SG2C18961723,Z74 ,SINGTEL,31-Mar-08,80,14,94
396,GTI2013,SG2C18961723,Z75,SYNEAR FOOD HOLDINGS LIMITED,31-Dec-12,34,-2,32
268,GTI2012,SG2C18961723,Z75,SYNEAR FOOD HLDGS LTD,31-Dec-10,37,-2,35
85,GTI2011,SG2C18961723,Z75,SYNEAR FOOD HOLDINGS LIMITED,31-Dec-09,45,-2,43
296,GTI2010,SG2C18961723,Z75,SYNEAR FOOD HOLDINGS LIMITED,31-Dec-08,37,-3,34
196,GTI2009,SG2C26962630,Z75,SYNEAR FOOD HOLDINGS LIMITED,31-Dec-07,38,0,38
196,GTI2012,SG2C26962630,,ADAMPAK LIMITED,31-Dec-10,38,0,38
317,GTI2012,SG2C28962695,,LEEDEN LIMITED,31-Dec-10,39,-6,33
317,GTI2012,SG2C28962695,,MEIBAN GROUP LTD,31-Dec-10,36,-3,33
379,GTI2012,SG2C33962847,,BEYONICSTECHNOLOGY LIMITED,31-Jul-11,37,-6,31
379,GTI2012,SG2C33962847,,WANXIANG INTERNATIONAL LIMITED,31-Dec-10,34,-3,31
410,GTI2012,SG2C34962861,,SMB UNITED LIMITED,31-Dec-10,38,-8,30
410,GTI2012,SG2C34962861,,THE STYLE MERCHANTS LIMITED,31-Mar-11,36,-6,30
410,GTI2012,SG2C35963611,,UNIDUX ELECTRONICS LIMITED,31-Dec-10,27,3,30
646,GTI2012,SG2C35963611,,CMZ HOLDINGS LTD.,31-Mar-11,24,-8,16
652,GTI2012,SG2C45963924,,CHINA HEALTHCARE LIMITED,31-Mar-11,31,-16,15
656,GTI2012,SG2C45963924,,CHT (HOLDINGS) LTD.,31-Dec-10,24,-10,14
76,GTI2011,SG2C46963931,,HENG LONG INTERNATIONAL LTD.,31-Dec-09,46,-2,44
92,GTI2011,SG2C46963931,,C & O PHARM TECH (HLDGS) LTD,30-Jun-10,39,3,42
118,GTI2011,SG2C46963931,,CENTRALAND LIMITED,31-Dec-09,45,-4,41
149,GTI2011,SG2C46963931,,KIM ENG HOLDINGS LIMITED,31-Dec-09,43,-5,38
186,GTI2011,SG2C47963963,,SWISSCO HOLDINGS LIMITED (FORMERLY C2O HOLDINGS LTD),28-Feb-10,33,3,36
210,GTI2011,SG2C50963991,,BEYONICS TECHNOLOGY LIMITED,31-Jul-10,38,-3,35
210,GTI2011,SG2C50963991,,LEEDEN LIMITED,31-Dec-09,43,-8,35
210,GTI2011,SG2C50963991,,TIME WATCH INVESTMENTS LIMITED,30-Jun-10,37,-2,35
210,GTI2011,SG2C50963991,,UNIDUX ELECTRONICS LIMITED,31-Dec-09,40,-5,35
230,GTI2011,SG2C50963991,,HSU FU CHI INTERNATIONAL LTD,30-Jun-10,31,3,34
230,GTI2011,SG2C61965225,,MAP TECHNOLOGY HLDGS LIMITED,31-Dec-09,42,-8,34
254,GTI2011,SG2C61965225,,EDMI LIMITED,31-Dec-09,35,-2,33
254,GTI2011,SG2C64965297,,PORTEK INTERNATIONAL LIMITED,30-Jun-10,43,-10,33
254,GTI2011,SG2C64965297,,QUALITAS MEDICAL GROUP LIMITED,31-Dec-09,30,3,33
281,GTI2011,SG2C64965297,,ADAMPAK LIMITED,31-Dec-09,37,-5,32
281,GTI2011,SG2C64965297,,THE STYLE MERCHANTS LIMITED (FORMERLY NETELUSION LTD),31-Mar-10,41,-9,32
325,GTI2011,SG2C64965297,,MEIBAN GROUP LTD,31-Dec-09,36,-6,30
377,GTI2011,SG2C70966271,,ALLGREEN PROPERTIES LTD,31-Dec-09,37,-9,28
377,GTI2011,SG2C70966271,,ASIA ENVIRONMENT HOLDINGS LTD,31-Dec-09,33,-5,28
407,GTI2011,SG2C70966271,,JK YAMING INT'L HLDGS LTD,31-Dec-09,29,-2,27
430,GTI2011,SG2C70966271,,SINOMEM TECHNOLOGY LIMITED,31-Dec-09,38,-12,26
430,GTI2011,SG2C70966271,,SMB UNITED LIMITED,31-Dec-09,34,-8,26
430,GTI2011,SG2C76966531,,ULTRO TECHNOLOGIES LIMITED,30-Jun-10,26,0,26
430,GTI2011,SG2C78966612,,WANXIANG INTERNATIONAL LIMITED,31-Dec-09,30,-4,26
496,GTI2011,SG2C78966612,,CMZ HOLDINGS LTD.,31-Mar-10,25,-2,23
575,GTI2011,SG2C82967234,,CHINA HEALTHCARE LIMITED,31-Mar-10,30,-13,17
575,GTI2011,SG2C82967234,,OCEAN INT'L HOLDINGS LIMITED,31-Dec-09,16,1,17
588,GTI2011,SG2C82967234,,MAVERIC LTD,30-Jun-10,24,-8,16
618,GTI2011,SG2C82967234,,JAPAN LAND LIMITED,31-May-10,42,-29,13
629,GTI2011,SG2C82967234,,FIRSTLINK INV CORP LTD,31-Dec-09,33,-22,11
635,GTI2011,SG2C88967436,,CHT (HOLDINGS) LTD.,31-Dec-09,25,-15,10
650,GTI2011,SG2C90967473,,SINO-ENVIRONMENT TECH GRP LTD,.,39,-38,1
652,GTI2011,SG2C93967918,,ORIENTAL CENTURY LIMITED,31-Dec-09,16,-17,-1
653,GTI2011,SG2C93967918,,E3 HOLDINGS LTD.,30-Jun-10,31,-33,-2
655,GTI2011,SG2C97968151,,FALMAC LIMITED,31-Dec-09,25,-28,-3
655,GTI2011,SG2C97968151,,NEL GROUP LTD. (FORMERLY NUCLEUS ELECTRONICS LTD),.,25,-28,-3
25,GTI2010,SG2C97968151,,SOILBUILD GROUP HOLDINGS LTD,31-Dec-08,55,1,56
48,GTI2010,SG2C97968151,,MCL LAND LIMITED,31-Dec-08,45,3,48
64,GTI2010,SG2C97968151,,EPURE INTERNATIONAL LTD.,31-Dec-08,43,3,46
99,GTI2010,SG2D04968848,,CENTRALAND LIMITED,31-Dec-08,45,-2,43
129,GTI2010,SG2D04968848,,TIME WATCH INVESTMENTS LIMITED,30-Jun-09,46,-5,41
148,GTI2010,SG2D04968848,,THOMSON MEDICAL CENTRE LIMITED,31-Aug-09,43,-3,40
148,GTI2010,SG2D04968848,,C & O PHARM TECH (HLDGS) LTD,30-Jun-09,43,-3,40
148,GTI2010,SG2D04968848,,PORTEK INTERNATIONAL LIMITED,30-Jun-09,50,-10,40
174,GTI2010,SG2D13002373,,PARKWAY HLDGS LTD,31-Dec-08,45,-6,39
174,GTI2010,SG2D13002373,,BEYONICSTECHNOLOGY LIMITED,31-Jul-09,42,-3,39
174,GTI2010,SG2D13002373,,MAP TECHNOLOGY HLDGS LIMITED,31-Dec-08,38,1,39
196,GTI2010,SG2D13002373,,ASIA ENVIRONMENT HOLDINGS LTD,31-Dec-08,38,0,38
196,GTI2010,SG2D13002373,,LEEDEN LIMITED,31-Dec-08,47,-9,38
235,GTI2010,SG2D30970271,,EDMI LIMITED,31-Dec-08,36,0,36
235,GTI2010,SG2D30970271,,CELESTIAL NUTRIFOODS LIMITED,31-Dec-08,41,-5,36
235,GTI2010,SG2D30970271,,ENG KONG HOLDINGS LIMITED,31-Dec-08,42,-6,36
235,GTI2010,SG2D30970271,,SMB UNITED LIMITED,31-Dec-08,39,-3,36
267,GTI2010,SG2D30970271,,KEDA COMMUNICATIONS LTD.,31-Mar-09,35,0,35
267,GTI2010,SG2D42972083,,FINANCIAL ONE CORP.,31-Dec-08,35,0,35
267,GTI2010,SG2D42972083,,IDT HOLDINGS (SINGAPORE) LTD,31-Mar-09,35,0,35
267,GTI2010,SG2D44972164,,PINE AGRITECH LIMITED,31-Dec-08,35,0,35
296,GTI2010,SG2D45972171,,UNIDUX ELECTRONICS LIMITED,31-Dec-08,39,-5,34
323,GTI2010,SG2D46972196,,HSU FU CHI INTERNATIONAL LTD,30-Jun-09,36,-3,33
323,GTI2010,SG2D46972196,,SSH CORPORATION LTD.,30-Jun-09,38,-5,33
352,GTI2010,SG2D46972196,,AQUA-TERRA SUPPLY CO. LIMITED,31-Dec-08,37,-5,32
352,GTI2010,SG2D46972196,,HENG LONG INTERNATIONAL LTD.,31-Dec-08,34,-2,32
352,GTI2010,SG2D46972196,,QUALITAS MEDICAL GROUP LIMITED,31-Dec-08,32,0,32
352,GTI2010,SG2D48972988,,REYOUNG PHARM HOLDINGS LIMITED,31-Dec-08,37,-5,32
352,GTI2010,SG2D51973063,,NETELUSION LIMITED,31-Mar-09,41,-9,32
395,GTI2010,SG2D51973063,,CHINA ANGEL FOOD LIMITED,31-Dec-08,33,-2,31
395,GTI2010,SG2D51973063,,KIM ENG HOLDINGS LIMITED,31-Dec-08,34,-3,31
417,GTI2010,SG2D51973063,,ULTRO TECHNOLOGIES LIMITED,30-Jun-09,32,-2,30
417,GTI2010,SG2D51973063,,AVAPLAS LTD,31-Mar-09,44,-14,30
417,GTI2010,SG2D54973185,,CHINA LIFESTYLE F&B GROUP LTD,31-Dec-08,35,-5,30
417,GTI2010,SG2D58973959,,RSH LIMITED,31-Mar-09,33,-3,30
447,GTI2010,SG2D65002396,,ZHONGGUO PENGJIE FABRICS LTD,31-Dec-08,26,3,29
468,GTI2010,SG2D65002396,,JK YAMING INT'L HLDGS LTD,31-Dec-08,28,0,28
468,GTI2010,SG2D65002396,,ADAMPAK LIMITED,31-Dec-08,36,-8,28
498,GTI2010,SG2D65002396,,BEAUTY CHINA HOLDINGS LIMITED,31-Dec-08,45,-18,27
498,GTI2010,SG2D65002396,,ROTOL SINGAPORE LIMITED,31-Mar-09,29,-2,27
498,GTI2010,SG2D67974808,,ALLGREEN PROPERTIES LTD,31-Dec-08,30,-3,27
524,GTI2010,SG2D72974892,,CHINA HEALTHCARE LIMITED,31-Mar-09,34,-8,26
524,GTI2010,SG2D82975475,,CHINA VIDEO SURVEILLANCE LTD (Formerly Yaan Security Technology Ltd),31-Dec-08,29,-3,26
524,GTI2010,SG2D87975520,,EASTERN ASIA TECHNOLOGY LTD,31-Dec-08,34,-8,26
524,GTI2010,SG2D90976473,,MAVERIC LTD,30-Jun-09,31,-5,26
543,GTI2010,SG2D90976473,,FIRSTLINK INV CORP LTD,31-Dec-08,33,-8,25
543,GTI2010,SG2D90976473,,HONGGUO INTL HOLDINGS LIMITED,31-Dec-08,31,-6,25
543,GTI2010,SG2D90976473,,SINOMEM TECHNOLOGY LIMITED,31-Dec-08,37,-12,25
564,GTI2010,SG2D90976473,,WANXIANG INTERNATIONAL LIMITED,31-Dec-08,29,-5,24
564,GTI2010,SG2D92977651,,MEIBAN GROUP LTD,31-Dec-08,30,-6,24
599,GTI2010,SG2E59979590,,CMZ HOLDINGS LTD.,31-Mar-09,25,-3,22
628,GTI2010,SG2E59979590,,MULTISTAR HOLDINGS LIMITED,31-Dec-08,31,-12,19
633,GTI2010,SG2E59979590,,OCEAN INT'L HOLDINGS LIMITED,31-Dec-08,17,1,18
640,GTI2010,SG2E59979590,,JURONG CEMENT LTD,31-Dec-08,31,-15,16
648,GTI2010,SG2E59979590,,FM HOLDINGS LIMITED,31-Mar-09,35,-20,15
648,GTI2010,SG2E65980228,,SINO-ENVIRONMENT TECH GRP LTD,31-Dec-08,45,-30,15
648,GTI2010,SG2E65980228,,CHT (HOLDINGS) LTD.,31-Dec-08,25,-10,15
652,GTI2010,SG2E65980228,,SWISSCO INTERNATIONAL LIMITED,31-Dec-08,38,-24,14
669,GTI2010,SG2E65980228,,JURONG TECH IND CORP LTD,31-Dec-07,30,-23,7
669,GTI2010,SG2E65980228,,ZHONGHUI HOLDINGS LTD.,31-Dec-08,29,-22,7
671,GTI2010,SG2E73981531,,ORIENTAL CENTURY LIMITED,31-Dec-08,24,-18,6
673,GTI2010,SG2E73981531,,JAPAN LAND LIMITED,31-May-09,43,-38,5
676,GTI2010,SG2E79981816,,FALMAC LIMITED,31-Dec-08,29,-31,-2
676,GTI2010,SG2E79981816,,E3 HOLDINGS LTD.,30-Jun-09,26,-28,-2
681,GTI2010,SG2E79981816,,NEL GROUP LTD. (FORMERLY NUCLEUS ELECTRONICS LTD),31-Dec-07,28,-37,-9
12,GTI2009,SG2E79981816,,SINGAPORE PETROLEUM CO LTD,31-Dec-07,58,3,61
15,GTI2009,SG2E79981816,,SOILBUILD GROUP HOLDINGS LTD,31-Dec-07,57,-2,55
40,GTI2009,SG2E89982663,,PARKWAY HLDGS LTD,31-Dec-07,51,-3,48
61,GTI2009,SG2E89982663,,EVERGRO PROPERTIES LIMITED,31-Dec-07,48,-3,45
111,GTI2009,SG2E89982663,,BABCOCK & BROWN GLOBAL INV LTD,31-Dec-07,44,-3,41
111,GTI2009,SG2E89982663,,BEAUTY CHINA HOLDINGS LIMITED,31-Dec-07,47,-6,41
111,GTI2009,SG2E89982663,,C K TANG LTD,31-Mar-08,44,-3,41
140,GTI2009,SG2E91982768,,BEYONICSTECHNOLOGY LIMITED,31-Jul-08,43,-3,40
140,GTI2009,SG2E91982768,,KEDA COMMUNICATIONS LTD.,31-Mar-08,45,-5,40
140,GTI2009,SG2E91982768,,MIDDLE EAST DEVT SPORE LTD.,30-Jun-08,48,-8,40
166,GTI2009,SG2E91982768,,EASTERN ASIA TECHNOLOGY LTD,31-Dec-07,39,0,39
166,GTI2009,SG2E91982768,,IDT HOLDINGS (SINGAPORE) LTD,31-Mar-08,41,-2,39
166,GTI2009,SG2F00983534,,JURONG CEMENT LTD,31-Dec-07,44,-5,39
166,GTI2009,SG2F00983534,,SIHUAN PHARMA HLDGS GROUP LTD.,31-Dec-07,44,-5,39
166,GTI2009,SG2F00983534,,ULTRO TECHNOLOGIES LIMITED,30-Jun-08,38,1,39
196,GTI2009,SG2F00983534,,CELESTIAL NUTRIFOODS LIMITED,31-Dec-07,46,-8,38
196,GTI2009,SG2F00983534,,CHINA LIFESTYLE F&B GROUP LTD,31-Dec-07,49,-11,38
196,GTI2009,SG2F02983607,,EDMI LIMITED,31-Dec-07,35,3,38
228,GTI2009,SG2F02983607,,ASIA ENVIRONMENT HOLDINGS LTD,31-Dec-07,40,-3,37
228,GTI2009,SG2F14985160,,ENPORIS GREENZ LIMITED,31-Dec-07,37,0,37
228,GTI2009,SG2F14985160,,ETLA LIMITED,31-Dec-07,39,-2,37
228,GTI2009,SG2F14985160,,GENTING INT'L PUBLIC LTD CO,31-Dec-07,40,-3,37
228,GTI2009,SG2F14985160,,JK YAMING INT'L HLDGS LTD,31-Dec-07,39,-2,37
228,GTI2009,SG2F14985160,,MCL LAND LIMITED,31-Dec-07,40,-3,37
228,GTI2009,SG2F17985415,,PINE AGRITECH LIMITED,31-Dec-07,42,-5,37
228,GTI2009,SG2F17985415,,SSH CORPORATION LTD.,30-Jun-08,37,0,37
266,GTI2009,SG2F25986140,,CHINA PRECISION TECHNOLOGY LTD,31-Dec-07,39,-3,36
266,GTI2009,SG2F25986140,,MAN WAH HOLDINGS LIMITED,31-Mar-08,44,-8,36
266,GTI2009,SG2F76992880,,THOMSON MEDICAL CENTRE LIMITED,31-Aug-08,45,-9,36
292,GTI2009,SG2G92002424,,AVAPLAS LTD,31-Mar-08,38,-3,35
292,GTI2009,SG2G92002424,,C & O PHARM TECH (HLDGS) LTD,30-Jun-08,38,-3,35
292,GTI2009,SG2G92002424,,CHINA ANGEL FOOD LIMITED,31-Dec-07,40,-5,35
292,GTI2009,SG2G92002424,,LEEDEN LIMITED,31-Dec-07,38,-3,35
292,GTI2009,SG2G92002424,,SINOMEM TECHNOLOGY LIMITED,31-Dec-07,40,-5,35
292,GTI2009,SG2L10002467,,TIME WATCH INVESTMENTS LIMITED,30-Jun-08,40,-5,35
330,GTI2009,SG2L10002467,,FM HOLDINGS LIMITED,31-Mar-08,36,-2,34
357,GTI2009,SG2L10002467,,FALMAC LIMITED,31-Dec-07,35,-2,33
357,GTI2009,SG2L10002467,,UNIDUX ELECTRONICS LIMITED,31-Dec-07,41,-8,33
357,GTI2009,SG2L10002467,,WANXIANG INTERNATIONAL LIMITED,31-Dec-07,32,1,33
383,GTI2009,SG2P14002527,,ALLGREEN PROPERTIES LTD,31-Dec-07,32,0,32
383,GTI2009,SG2P14002527,,CHUNGHONG HOLDINGS LIMITED,31-Dec-07,31,1,32
383,GTI2009,SG2P14002527,,HONGGUO INTL HOLDINGS LIMITED,31-Dec-07,35,-3,32
383,GTI2009,SG2P14002527,,HSU FU CHI INTERNATIONAL LTD,30-Jun-08,32,0,32
407,GTI2009,SG2P14002527,,ASIA DEKOR HOLDINGS LIMITED,31-Dec-07,34,-3,31
407,GTI2009,SG2P22002535,,CHINA HEALTHCARE LIMITED,31-Mar-08,33,-2,31
407,GTI2009,SG2P22002535,,ENG KONG HOLDINGS LIMITED,31-Dec-07,37,-6,31
407,GTI2009,SG2P22002535,,FASTECH SYNERGY LTD,31-Dec-07,37,-6,31
407,GTI2009,SG2P22002535,,JURONG TECH IND CORP LTD,31-Dec-07,39,-8,31
407,GTI2009,SG2P22002535,,MAP TECHNOLOGY HLDGS LIMITED,31-Dec-07,33,-2,31
407,GTI2009,SG2P56002559,,MEIBAN GROUP LTD,31-Dec-07,37,-6,31
407,GTI2009,SG2P56002559,,REYOUNG PHARM HOLDINGS LIMITED,31-Dec-07,42,-11,31
407,GTI2009,SG2P56002559,,ROTOL SINGAPORE LIMITED,31-Mar-08,36,-5,31
442,GTI2009,SG2P56002559,,AQUA-TERRA SUPPLY CO. LIMITED,31-Dec-07,38,-8,30
442,GTI2009,SG2P56002559,,FINANCIAL ONE CORP.,31-Dec-07,32,-2,30
442,GTI2009,SG2R04002568,,KIM ENG HOLDINGS LIMITED,31-Dec-07,38,-8,30
442,GTI2009,SG2R04002568,,NETELUSION LIMITED,31-Mar-08,33,-3,30
442,GTI2009,SG2R04002568,,YAAN SECURITY TECHNOLOGY LTD,31-Dec-07,35,-5,30
463,GTI2009,SG2R04002568,,CMZ HOLDINGS LTD.,31-Mar-08,32,-3,29
463,GTI2009,SG2R04002568,,MEMORY DEVICES LIMITED,31-Dec-07,36,-7,29
463,GTI2009,Suspended,,PORTEK INTERNATIONAL LIMITED,30-Jun-08,43,-14,29
463,GTI2009,TH0254A10Z14,,SINO-ENVIRONMENT TECH GRP LTD,31-Dec-07,41,-12,29
485,GTI2009,TH0554010Z14,,E3 HOLDINGS LTD.,30-Jun-08,31,-3,28
485,GTI2009,TH0554010Z14,,IONICS EMS INC,31-Dec-07,33,-5,28
505,GTI2009,TH0554010Z14,,ICONIC HOLDINGS LIMITED,30-Jun-08,32,-5,27
505,GTI2009,TH0554010Z14,,JAPAN LAND LIMITED,31-Mar-08,44,-17,27
529,GTI2009,TH0902010014,,AGVA CORPORATION LIMITED,31-Dec-07,32,-6,26
529,GTI2009,TH0902010014,,CHUAN SOON HUAT INDUSTRIAL GP,31-Dec-07,38,-12,26
529,GTI2009,TH0902010014,,GIANT WIRELESS TECHNOLOGY LTD,31-Mar-08,34,-8,26
529,GTI2009,TH0902010014,,MULTISTAR HOLDINGS LIMITED,31-Dec-07,38,-12,26
529,GTI2009,TH0902010014,,SMB UNITED LIMITED,31-Dec-07,29,-3,26
558,GTI2009,TH0955010002,,FURAMA LTD.,31-Dec-07,27,-2,25
574,GTI2009,TH0955010002,,FIRSTLINK INV CORP LTD,31-Dec-07,29,-5,24
591,GTI2009,TH0955010002,,ADAMPAK LIMITED,31-Dec-07,34,-11,23
591,GTI2009,TH0955010002,,GENERAL MAGNETICS LTD,31-Dec-07,31,-8,23
607,GTI2009,TH0955010002,,ADVANCE MODULES GROUP LIMITED,31-Dec-07,40,-18,22
607,GTI2009,VGG2156N1006,,RSH LIMITED,31-Mar-08,35,-13,22
615,GTI2009,VGG2156N1006,,UNITED PULP & PAPER CO. LTD,31-Dec-07,26,-5,21
644,GTI2009,VGG2156N1006,,SWISSCO INTERNATIONAL LIMITED,31-Dec-07,52,-34,18
653,GTI2009,VGG2156N1006,,ZHONGHUI HOLDINGS LTD.,31-Dec-07,25,-9,16
659,GTI2009,VGG2156N1006,,CHT (HOLDINGS) LTD.,31-Dec-07,27,-13,14
665,GTI2009,VGG270541169,,FERROCHINA LIMITED,31-Dec-07,26,-15,11
669,GTI2009,VGG270541169,,OCEAN INT'L HOLDINGS LIMITED,31-Dec-07,19,-10,9
669,GTI2009,VGG270541169,,ORIENTAL CENTURY LIMITED,31-Dec-07,29,-20,9
671,GTI2009,VGG270541169,,ASA GROUP HOLDINGS LTD,31-Mar-08,30,-23,7
676,GTI2009,VGG270541169,,NEL GROUP LTD. (FORMERLY NUCLEUS ELECTRONICS LTD),31-Dec-07,28,-34,-6
